но́вы	nóvy	[ˈnovɨ]
сусве́т	susvjét	[suˈsvʲet]
прына́мсі	u-	[prɨˈnamsʲi]
ве́льмі	vjélʹmi	[ˈvʲelʲmʲi]
ва́нна	vánna	[ˈvanːa]
капялю́ш	kapjaljúš	[kapʲaˈlʲuʂ]
сяке́ра	*sjakíra	[sʲaˈkʲera]
тапо́р	tapór	[taˈpor]
адзёр	adzjór	[aˈd͡zʲor]
тлума́ч	tlumáč	[tɫuˈmat͡ʂ]
сур'ёзны	surʺjózny	[suˈrjoznɨ]
Мсці́слаў	Mscíslaŭ	[ˈmsʲt͡sʲisɫau̯]
сталі́ца	stalíca	[staˈlʲit͡sa]
ша́бля	šáblja	[ˈʂablʲa]
сло́ўнік	slóva	[ˈsɫou̯nʲik]
белару́скі	bjelarúski	[bʲeɫaˈruskʲi]
ве́льмі	vjélʹmi	[ˈvʲelʲmʲi]
інцэ́ст	incést	[jinˈt͡sest]
каха́нне	kaxácʹ	[kaˈxanʲːe]
ко́жны	kóžny	[ˈkoʐnɨ]
		
ігла́	ihlá	[jiˈɣɫa]
іго́лка	ihlá	[jiˈɣoɫka]
ілга́ць	ilhácʹ	[jiɫˈɣat͡sʲ]
імгла́	imhlá	[jimˈɣɫa]
імя́	imjá	[jiˈmʲa]
інцэ́ст	incést	[jinˈt͡sest]
іншазе́мец	ínšy	[jinʂaˈzʲemʲet͡s]
і́ншы	ínšy	[ˈjinʂɨ]
іржа́	iržá	[jirˈʐa]
іржа́вы	iržá	[jirˈʐavɨ]
і́скра	ískra	[ˈjiskra]
істо́тны	istóta	[jiˈstotnɨ]
Іта́лія	Itálija	[jiˈtalʲija]
ў	u	/w/
аўто́бус	aŭtóbus	[au̯ˈtobus]
аўто́рак	aŭtórak	[au̯ˈtorak]
абавя́зак	abavjázak	[abaˈvʲazak]
абавяза́цельства	vjazácʹ	[abavʲaˈzat͡sʲelʲstva]
абавязко́вы	abavjázak	[abavʲaˈskovɨ]
абарача́цца	abaračácca	[abaraˈt͡ʂat͡sːa]
абаро́на	abaróna	[abaˈrona]
абвінава́ціць	abvinavácicʹ	[abvʲinaˈvat͡sʲit͡sʲ]
аблі́чча	ablíčča	[aˈblʲit͡ʂːa]
абры́длівы	abrýdlivy	[aˈbrɨdlʲivɨ]
абцугі́	abcuhí	[apt͡suˈɣʲi]
абяца́ць	abjacácʹ	[abʲaˈt͡sat͡sʲ]
аванту́рны	avantúra	[avanˈturnɨ]
авёс	avjós	[aˈvʲos]
агі́да	ahída	[aˈɣʲida]
агаро́джа	aharódža	[aɣaˈrod͡ʐa]
аго́нь	ahónʹ	[aˈɣonʲ]
агу́льны	ahúlʹny	[aˈɣulʲnɨ]
агуро́к	ahurók	[aɣuˈrok]
адва́га	adváha	[aˈdvaɣa]
адва́жны	adváha	[aˈdvaʐnɨ]
адво́льны	advólʹny	[aˈdvolʲnɨ]
адгавары́ць	ad-	[adɣavaˈrɨt͡sʲ]
адзі́ны	adzín	[aˈd͡zʲin]
адзе́жа	adzjéža	[aˈd͡zʲeʐa]
адзёр	adzjór	[aˈd͡zʲor]
адка́зны	adkaz	[aˈtkaznɨ]
адкла́д	adklasci	[aˈtkɫat]
адку́ль	adkúlʹ	[aˈtkulʲ]
аднаво́кі	adzín	[adnaˈvokʲi]
аднакаляро́вы	adzín	[adnakalʲaˈrovɨ]
аднашлю́бнасць	adnašljúbny	[adnaˈʂlʲubnasʲt͡sʲ]
аднашлю́бны	adzín	[adnaˈʂlʲubnɨ]
адно́сны	adnósny	[aˈdnosnɨ]
а́драс	ádras	[ˈadras]
адро́зны	adrózny	[aˈdroznɨ]
адсу́тнічаць	adsútny	[aˈtsutnʲit͡ʂat͡sʲ]
адсу́тны	adsútny	[aˈtsutnɨ]
адчыні́ць	adčynícʹ	[atː͡ʂɨˈnʲit͡sʲ]
айце́ц	ajcjéc	[ajˈt͡sʲet͡s]
акно́	vaknó	[aˈkno]
аку́ла	akúla	[aˈkuɫa]
акуля́ры	akuljáry	[akuˈlʲarɨ]
але́	aljé	[aˈlʲe]
але́нь	aljénʹ	[aˈlʲenʲ]
ало́вак	alóvak	[aˈɫovak]
амерыка́нец	amjerykánjec	[amʲerɨˈkanʲet͡s]
Ангелі́на	Anhjelína	[anɣʲeˈlʲina]
апіса́нне	apisácʹ	[apʲiˈsanʲːe]
апіса́ць	apisácʹ	[apʲiˈsat͡sʲ]
апа́рыш	apáryš	[aˈparɨʂ]
апо́шні	apaslja	[aˈpoʂnʲi]
апрана́ць	apranácʹ	[apraˈnat͡sʲ]
ара́нжавы	aránžavy	[aˈranʐavɨ]
аро́л	aról	[aˈroɫ]
арэ́х	aréx	[aˈrex]
оса́	osá	[aˈsa]
асаблі́вы	asóba	[asaˈblʲivɨ]
асёл	asjól	[aˈsʲoɫ]
асе́лы	asjély	[aˈsʲeɫɨ]
асно́ва	asnóva	[aˈsnova]
асно̀ватво́рны	asnóva	[aˌsnovaˈtvornɨ]
асо́ба	asóba	[aˈsoba]
астрано́м	astranóm	[astraˈnom]
асяро́ддзе	a-	[asʲaˈrod͡zʲːe]
атру́та	atrúta	[aˈtruta]
атру́тны	atrúta	[aˈtrutnɨ]
ахвя́ра	axvjára	[aˈxvʲara]
бірузо́вы	biruza	[bʲiruˈzovɨ]
бабёр	babjór	[baˈbʲor]
баваўня́ны	bavaŭnjány	[bavau̯ˈnʲanɨ]
баво́ўна	bavóŭna	[baˈvou̯na]
бага́ты	baháty	[baˈɣatɨ]
бага́цце	baháty	[baˈɣat͡sʲːe]
багра́ны	báhra	[baˈɣranɨ]
бало́та	balóta	[baˈɫota]
барада́	baradá	[baraˈda]
барада́ты	baradáty	[baraˈdatɨ]
баразна́	barazná	[baraˈzna]
бара́н	barán	[baˈran]
баро́даўка	baródaŭka	[baˈrodau̯ka]
ба́цька	bácja	[ˈbat͡sʲka]
ба́чыць	báčycʹ	[ˈbat͡ʂɨt͡sʲ]
бе́гаць	bjéhacʹ	[ˈbʲeɣat͡sʲ]
бедната́	bjédny	[bʲednaˈta]
бе́дны	bjadá	[ˈbʲednɨ]
бе́здань	bjez	[ˈbʲezdanʲ]
безназо́ўны	bjez-	[bʲeznaˈzou̯nɨ]
белару́скі	bjelarúski	[bʲeɫaˈruskʲi]
Белару́сь	Bjelarúsʹ	[bʲeɫaˈrusʲ]
бе́лы	bjély	[ˈbʲeɫɨ]
бе́раг	bjérah	[ˈbʲerax]
бервяно́	bjervjanó	[bʲervʲaˈno]
берылі̀й	bjerylìj	[bʲerɨlʲij]
бессмяро́тны	bjez	[bʲesʲːmʲaˈrotnɨ]
бесстаро́нні	bjez-	[bʲesːtaˈronʲːi]
блі́зкі	blízki	[ˈblʲiskʲi]
благі́	blahí	[bɫaˈɣʲi]
блакі́тны	blakítny	[bɫaˈkʲitnɨ]
блыха́	blyxá	[bɫɨˈxa]
боль	bolʹ	[bolʲ]
бо́льшасць	bólʹšasʹcʹ	[ˈbolʲʂasʲt͡sʲ]
бо́рзды	bórzdy	[ˈborzdɨ]
брахня́	braxácʹ	[braˈxnʲa]
бра́цтва	brat	[ˈbrat͡stva]
браць	bracʹ	[brat͡sʲ]
бру́дны	brúdny	[ˈbrudnɨ]
брыво́	bryvó	[brɨˈvo]
бры́дкі	brýdki	[ˈbrɨtkʲi]
бры́тва	brýtva	[ˈbrɨtva]
будава́нне	budavácʹ	[budaˈvanʲːe]
будава́ць	budavácʹ	[budaˈvat͡sʲ]
бу́дучы	bycʹ	[ˈbudut͡ʂɨ]
бу́дучыня	búdučy	[ˈbudut͡ʂɨnʲa]
буды́нак	budýnak	[buˈdɨnak]
бу́йны	bújny	[ˈbujnɨ]
булава́	bulavá	[buɫaˈva]
бу́льба	búlʹba	[ˈbulʲba]
бура́к	burák	[buˈrak]
бу́сел	búsjel	[ˈbusʲeɫ]
бутэ́лька	butélʹka	[buˈtelʲka]
бык	byk	[bɨk]
бы́стры	býstry	[ˈbɨstrɨ]
быстрыня́	býstry	[bɨstrɨˈnʲa]
быць	bycʹ	[bɨt͡sʲ]
бядро́	bjadró	[bʲaˈdro]
бязглу́зды	bjazhlúzdy	[bʲaˈzɡɫuzdɨ]
бяро́за	bjaróza	[bʲaˈroza]
бярэ́мя	bjarémja	[bʲaˈremʲa]
бяспе́чны	bjaspjéka	[bʲaˈsʲpʲet͡ʂnɨ]
відо́вішча	vídzjecʹ	[vʲiˈdovʲiʂt͡ʂa]
Вікіпэ́дыя	Vikipédyja	[vʲikʲiˈpedɨja]
вільго́тны	vilʹhótny	[vʲilʲˈɣotnɨ]
вінава́льны	vinavácicʹ	[vʲinaˈvalʲnɨ]
вінава́ты	viná	[vʲinaˈvatɨ]
віншава́ць	vinšavácʹ	[vʲinʂaˈvat͡sʲ]
віта́ць	vitácʹ	[vʲiˈtat͡sʲ]
віху́ра	víxur	[vʲiˈxura]
ваўкала́к	vaŭkalák	[vau̯kaˈɫak]
вавёрка	vavjórka	[vaˈvʲorka]
вада́	vadá	[vaˈda]
вадаспа́д	vadá	[vadaˈspat]
вадзі́ць	vadzícʹ	[vaˈd͡zʲit͡sʲ]
ва́жны	vážny	[ˈvaʐnɨ]
валакно́	valaknó	[vaɫaˈkno]
ванітава́ць	vanitavácʹ	[vanʲitaˈvat͡sʲ]
вандроўны	vandravácʹ	[vanˈdrou̯nɨ]
ва́нна	vánna	[ˈvanːa]
вантро́ба	vutróbny	[vanˈtroba]
вараны́	varaný	[varaˈnɨ]
варата́р	varóty	[varaˈtar]
варо́жы	vórah	[vaˈroʐɨ]
варо́на	varóna	[vaˈrona]
ве́даць	vjédacʹ	[ˈvʲedat͡sʲ]
ве́йка	vjejacʹ	[ˈvʲejka]
велічыня́	vjalíki	[vʲelʲit͡ʂɨˈnʲa]
ве́льмі	vjélʹmi	[ˈvʲelʲmʲi]
ве́ра	vjéra	[ˈvʲera]
верабе́й	vjerabjéj	[vʲeraˈbʲej]
вераго́дны	vjéra	[vʲeraˈɣodnɨ]
ве́рад	vjérad	[ˈvʲerat]
верацяно́	vjeracjanó	[vʲerat͡sʲaˈno]
ве́рны	vjéra	[ˈvʲernɨ]
верталёт	vjarcjécʹ	[vʲertaˈlʲot]
ве́рыць	vjéra	[ˈvʲerɨt͡sʲ]
ве́тлівы	-livy	[ˈvʲetlʲivɨ]
ве́чар	vjéčar	[ˈvʲet͡ʂar]
ве́чны	vjéčny	[ˈvʲet͡ʂnɨ]
воўк	voŭk	[vou̯k]
во́ўна	vóŭna	[ˈvou̯na]
во́блака	vóblaka	[ˈvobɫaka]
во́бласць	vóblascʹ	[ˈvobɫasʲt͡sʲ]
во́браз	vóbraz	[ˈvobras]
во́дарасць	vadá	[ˈvodarasʲt͡sʲ]
во́жык	vóžyk	[ˈvoʐɨk]
во́зера	vózjera	[ˈvozʲera]
во́ка	vóka	[ˈvoka]
во́лава	vólava	[ˈvoɫava]
во́лас	vólas	[ˈvoɫas]
во́раг	vórah	[ˈvorax]
во́ран	vóran	[ˈvoran]
во́сень	vósjenʹ	[ˈvosʲenʲ]
воск	vosk	[vosk]
во́страў	vóstraŭ	[ˈvostrau̯]
во́стры	vóstry	[ˈvostrɨ]
но́вы	nóvy	[ˈnovɨ]
сусве́т	susvjét	[suˈsvʲet]
прына́мсі	u-	[prɨˈnamsʲi]
ве́льмі	vjélʹmi	[ˈvʲelʲmʲi]
ва́нна	vánna	[ˈvanːa]
капялю́ш	kapjaljúš	[kapʲaˈlʲuʂ]
сяке́ра	*sjakíra	[sʲaˈkʲera]
тапо́р	tapór	[taˈpor]
адзёр	adzjór	[aˈd͡zʲor]
тлума́ч	tlumáč	[tɫuˈmat͡ʂ]
сур'ёзны	surʺjózny	[suˈrjoznɨ]
Мсці́слаў	Mscíslaŭ	[ˈmsʲt͡sʲisɫau̯]
сталі́ца	stalíca	[staˈlʲit͡sa]
ша́бля	šáblja	[ˈʂablʲa]
сло́ўнік	slóva	[ˈsɫou̯nʲik]
белару́скі	bjelarúski	[bʲeɫaˈruskʲi]
ве́льмі	vjélʹmi	[ˈvʲelʲmʲi]
інцэ́ст	incést	[jinˈt͡sest]
каха́нне	kaxácʹ	[kaˈxanʲːe]
ко́жны	kóžny	[ˈkoʐnɨ]
вось	vosʹ	[vosʲ]
во́цат	vócat	[ˈvot͡sat]
вош	voš	[voʂ]
ву́гал	vúhal	[ˈvuɣaɫ]
ву́галь	vúhalʹ	[ˈvuɣalʲ]
вуго́льчык	vúhalʹ	[vuˈɣolʲt͡ʂɨk]
вуго́р	vuhór	[vuˈɣor]
ву́да	vúda	[ˈvuda]
вуж	vuž	[vuʂ]
вуздэ́чка	vuzdéčka	[vuˈzdet͡ʂka]
ву́зел	vjénzjelʹ	[ˈvuzʲeɫ]
ву́зкі	vúzki	[ˈvuskʲi]
ву́ліца	vúlica	[ˈvulʲit͡sa]
ву́лей	vúljej	[ˈvulʲej]
ву́сік	vus	[ˈvusʲik]
ву́сень	vúsjenʹ	[ˈvusʲenʲ]
ву́сны	vustá	[ˈvusnɨ]
ву́стрыца	vústryca	[ˈvustrɨt͡sa]
		
вушны́	vúxa	[vuˈʂnɨ]
выбача́йце	vybačácʹ	[vɨbaˈt͡ʂajt͡sʲe]
вы́бачыць	výbačycʹ	[ˈvɨbat͡ʂɨt͡sʲ]
выда́тны	vydátny	[vɨˈdatnɨ]
вы́капень	výkapjenʹ	[ˈvɨkapʲenʲ]
выклі́чнік	-nik	[vɨˈklʲit͡ʂnʲik]
выключа́ць	vyključácʹ	[vɨklʲuˈt͡ʂat͡sʲ]
вы́мавіць	vy-	[ˈvɨmavʲit͡sʲ]
вы́нік	výnik	[ˈvɨnʲik]
вынахо́дства	vynaxódzicʹ	[vɨnaˈxotstva]
вы́нятак	výnjatak	[ˈvɨnʲatak]
вынятко́вы	výnjatak	[vɨnʲaˈtkovɨ]
выпрабава́нне	výprabavacʹ	[vɨprabaˈvanʲːe]
вы́раз	výraz	[ˈvɨras]
выра́зны	výraz	[vɨˈraznɨ]
высо́кі	vysóki	[vɨˈsokʲi]
вядо́ма	vjadómy	[vʲaˈdoma]
вядо́мы	vjadómy	[vʲaˈdomɨ]
вядро́	vjadró	[vʲaˈdro]
вяза́ць	vjazácʹ	[vʲaˈzat͡sʲ]
вя́зень	vjazácʹ	[ˈvʲazʲenʲ]
вялі́зны	vjalízny	[vʲaˈlʲiznɨ]
вялі́кі	vjalíki	[vʲaˈlʲikʲi]
Вялі́кдзень	vjalíki	[vʲaˈlʲiɡd͡zʲenʲ]
вярба́	vjarbá	[vʲarˈba]
вярблю́д	vjarbljúd	[vʲarˈblʲut]
вяро́ўка	vjaróŭka	[vʲaˈrou̯ka]
вясёлка	vjasjólka	[vʲaˈsʲoɫka]
вясе́лле	vjasjóly	[vʲaˈsʲelʲːe]
вясёлы	vjasjóly	[vʲaˈsʲoɫɨ]
вясло́	vjasló	[vʲaˈsɫo]
вясна́	vjasná	[vʲaˈsna]
Вячасла́ў	Vjačasláŭ	[vʲat͡ʂaˈsɫau̯]
гі́дкі	hídki	[ˈɣʲitkʲi]
гаваркі́	havarýcʹ	[ɣavarˈkʲi]
гаварлі́вы	havarýcʹ	[ɣavaˈrlʲivɨ]
гавары́ць	havarýcʹ	[ɣavaˈrɨt͡sʲ]
гадзі́на	xvilína	[ɣaˈd͡zʲina]
гадзі́ннік	hadzína	[ɣaˈd͡zʲinʲːik]
галіна́	hóly	[ɣalʲiˈna]
Галі́на	Halína	[ɣaˈlʲina]
галава́	halavá	[ɣaɫaˈva]
галёнка	haljónka	[ɣaˈlʲonka]
гало́ўка	halavá	[ɣaˈɫou̯ka]
гало́ўны	halavá	[ɣaˈɫou̯nɨ]
гало́дны	hólad	[ɣaˈɫodnɨ]
га́льштук	hálʹštuk	[ˈɣalʲʂtuk]
ганарлі́вы	hónar	[ɣanaˈrlʲivɨ]
гарбу́з	harbúz	[ɣarˈbus]
гаро́х	haróx	[ɣaˈrox]
гарэ́ць	harécʹ	[ɣaˈret͡sʲ]
гаспада́рка	haspadár	[ɣaspaˈdarka]
гато́вы	hatóvy	[ɣaˈtovɨ]
гвалтава́ць	hvalcícʹ	[ɣvaɫtaˈvat͡sʲ]
гвозд	hvozd	[ɣvost]
гла́дкі	hládki	[ˈɣɫatkʲi]
глу́пства	hlúpstva	[ˈɣɫupstva]
глухі́	hluxí	[ɣɫuˈxʲi]
глыбо́кі	hlybóki	[ɣɫɨˈbokʲi]
гнілы́	hnilý	[ɣnʲiˈɫɨ]
гняздо́	hnjazdó	[ɣnʲaˈzdo]
год	hod	[ɣot]
го́днасць	hódny	[ˈɣodnasʲt͡sʲ]
го́дны	hadzícʹ	[ˈɣodnɨ]
го́жы	hóžy	[ˈɣoʐɨ]
го́лад	hólad	[ˈɣoɫat]
го́лас	hólas	[ˈɣoɫas]
го́ласны	hólas	[ˈɣoɫasnɨ]
го́луб	hólub	[ˈɣoɫup]
го́лы	hóly	[ˈɣoɫɨ]
Гомель	Hómiel’	[ˈɣomʲelʲ]
го́нар	hónar	[ˈɣonar]
го́рад	hórad	[ˈɣorat]
го́рды	hórdy	[ˈɣordɨ]
го́ркі	hórki	[ˈɣorkʲi]
го́рла	hórla	[ˈɣorɫa]
го́ршы	hóršy	[ˈɣorʂɨ]
госць	hoscʹ	[ɣosʲt͡sʲ]
грамадзя́нін	hramada	[ɣramaˈd͡zʲanʲin]
грамадзя́нства	hramadzjánin	[ɣramaˈd͡zʲanstva]
грама́дства	hramada	[ɣraˈmatstva]
грані́ца	hraníca	[ɣraˈnʲit͡sa]
грані́чны	hraníca	[ɣraˈnʲit͡ʂnɨ]
гру́бы	hrúby	[ˈɣrubɨ]
гру́ша	hrúša	[ˈɣruʂa]
грэх	hrex	[ɣrex]
гумары́ст	humarýst	[ɣumaˈrɨst]
густы́	hustý	[ɣuˈstɨ]
гу́чны	huk	[ˈɣut͡ʂnɨ]
да пабачэ́ння	da pabačénnja	[da pabaˈt͡ʂenʲːa]
даўгата́	dóŭhi	[dau̯ɣaˈta]
да́ўні	dáŭni	[ˈdau̯nʲi]
даўніна́	dáŭni	[dau̯nʲiˈna]
дава́льны	davácʹ	[daˈvalʲnɨ]
далёкі	daljóki	[daˈlʲokʲi]
дало́ў	dalóŭ	[daˈɫou̯]
дало́нь	dalónʹ	[daˈɫonʲ]
дапамо́га	dapamahácʹ	[dapaˈmoɣa]
дапы́тлівы	-livy	[daˈpɨtlʲivɨ]
дарагі́	darahí	[daraˈɣʲi]
даро́слы	rascí	[daˈrosɫɨ]
дарэ́чы	daréčy	[daˈret͡ʂɨ]
дастатко́ва	dastatkóvy	[dastaˈtkova]
дастатко́вы	dastátak	[dastaˈtkovɨ]
дачка́	dačká	[daˈt͡ʂka]
два	dva	[dva]
двор	dvor	[dvor]
дзі́ўны	dzíva	[ˈd͡zʲiu̯nɨ]
дзі́ва	dzíva	[ˈd͡zʲiva]
дзі́кі	dzíki	[ˈd͡zʲikʲi]
дзе́вер	dzjévjer	[ˈd͡zʲevʲer]
дзёгаць	dzjóhacʹ	[ˈd͡zʲoɣat͡sʲ]
дзед	dzjed	[d͡zʲet]
дзеепрыме́тнік	dzjéjacʹ	[d͡zʲejeprɨˈmʲetnʲik]
дзе́йнік	dzjéjacʹ	[ˈd͡zʲejnʲik]
дзе́йнічаць	dzjéjnik	[ˈd͡zʲejnʲit͡ʂat͡sʲ]
дзень	hadzína	[d͡zʲenʲ]
дзе́сьці	dzje	[ˈd͡zʲesʲt͡sʲi]
дзесяціго́ддзе	dzjésjacʹ	[d͡zʲesʲat͡sʲiˈɣod͡zʲːe]
дзеясло́ў	dzjéjacʹ	[d͡zʲejaˈsɫou̯]
дзе́яць	dzjéjacʹ	[ˈd͡zʲejat͡sʲ]
дзю́ба	dzjúba	[ˈd͡zʲuba]
дзя́дзька	dzjádzʹka	[ˈd͡zʲat͡sʲka]
дзя́каваць	dzjákavacʹ	[ˈd͡zʲakavat͡sʲ]
дзя́куй	dzjákuj	[ˈd͡zʲakuj]
дзяржа́ва	dzjaržáva	[d͡zʲarˈʐava]
дзяці́нства	-stva	[d͡zʲaˈt͡sʲinstva]
дзя́цел	dzjácjel	[ˈd͡zʲat͡sʲeɫ]
дно	dno	[dno]
доўг	doŭh	[dou̯x]
до́ўгі	dóŭhi	[ˈdou̯ɣʲi]
до́бры	dóbry	[ˈdobrɨ]
дождж	doždž	[doʂt͡ʂ]
до́каз	dókaz	[ˈdokas]
до́лата	dólata	[ˈdoɫata]
до́шка	dóška	[ˈdoʂka]
драбі́ны	drabíny	[draˈbʲinɨ]
дра́паць	drápacʹ	[ˈdrapat͡sʲ]
дро́бны	dróbny	[ˈdrobnɨ]
дро́жджы	dróždžy	[ˈdroʐd͡ʐɨ]
другі́	dva	[druˈɣʲi]
дрэ́ва	dzjérava	[ˈdreva]
дрэ́нны	drenʹ	[ˈdrenːɨ]
дуб	dub	[dup]
дурны́	durný	[duˈrnɨ]
дух	dux	[dux]
душа́	dušá	[duˈʂa]
ду́шны	dúšny	[ˈduʂnɨ]
дым	dym	[dɨm]
ды́ня	dýnja	[ˈdɨnʲa]
дэндрахранало́гія	dendraxranaljóhija	[dendraxranaˈɫoɣʲija]
Еўро́па	Eŭrópa	[jeu̯ˈropa]
ён	jon	[jon]
е́сці	jésʹci	[ˈjesʲt͡sʲi]
е́хаць	jéxacʹ	[ˈjexat͡sʲ]
жа́ба	žába	[ˈʐaba]
жабра́к	žabrák	[ʐaˈbrak]
жада́ць	žadácʹ	[ʐaˈdat͡sʲ]
жа́ласны	žalascʹ	[ˈʐaɫasnɨ]
жале́за	marhanjec	[ʐaˈlʲeza]
жалоба	žalóba	[ʐaˈɫoba]
жані́х	žaná	[ʐaˈnʲix]
жано́цкі	žónka	[ʐaˈnot͡skʲi]
жано́чы	žónka	[ʐaˈnot͡ʂɨ]
жанчы́на	žančýna	[ʐanˈt͡ʂɨna]
жарабе́ц	žarabjéc	[ʐaraˈbʲet͡s]
жарало́	žaraló	[ʐaraˈɫo]
жахлі́вы	žax	[ʐaˈxlʲivɨ]
жні́вень	żniwień	[ˈʐnʲivʲenʲ]
жніво́	žacʹ	[ʐnʲiˈvo]
жо́ўты	žóŭty	[ˈʐou̯tɨ]
жо́лаб	žlob	[ˈʐoɫap]
жо́луд	žólud	[ˈʐoɫut]
жо́нка	žaná	[ˈʐonka]
жо́рсткі	šórstki	[ˈʐorstkʲi]
жывы́	žyvý	[ʐɨˈvɨ]
жы́ла	žýla	[ˈʐɨɫa]
жы́та	žýta	[ˈʐɨta]
жыццё	žycʹcjó	[ʐɨˈt͡sʲːo]
жэ́рабя	žérabja	[ˈʐerabʲa]
зіма́	zimá	[zʲiˈma]
но́вы	nóvy	[ˈnovɨ]
сусве́т	susvjét	[suˈsvʲet]
прына́мсі	u-	[prɨˈnamsʲi]
ве́льмі	vjélʹmi	[ˈvʲelʲmʲi]
ва́нна	vánna	[ˈvanːa]
капялю́ш	kapjaljúš	[kapʲaˈlʲuʂ]
сяке́ра	*sjakíra	[sʲaˈkʲera]
тапо́р	tapór	[taˈpor]
адзёр	adzjór	[aˈd͡zʲor]
тлума́ч	tlumáč	[tɫuˈmat͡ʂ]
сур'ёзны	surʺjózny	[suˈrjoznɨ]
Мсці́слаў	Mscíslaŭ	[ˈmsʲt͡sʲisɫau̯]
сталі́ца	stalíca	[staˈlʲit͡sa]
ша́бля	šáblja	[ˈʂablʲa]
сло́ўнік	slóva	[ˈsɫou̯nʲik]
белару́скі	bjelarúski	[bʲeɫaˈruskʲi]
ве́льмі	vjélʹmi	[ˈvʲelʲmʲi]
інцэ́ст	incést	[jinˈt͡sest]
каха́нне	kaxácʹ	[kaˈxanʲːe]
ко́жны	kóžny	[ˈkoʐnɨ]
заўжды́	zaŭždý	[zau̯ˈʐdɨ]
заўзя́ты	zaŭzjáty	[zau̯ˈzʲatɨ]
заўсёды	zaŭsjódy	[zau̯ˈsʲodɨ]
за́ўтра	záŭtra	[ˈzau̯tra]
заахво́ціць	zaaxvócicʹ	[zaaˈxvot͡sʲit͡sʲ]
забі́ць	zabícʹ	[zaˈbʲit͡sʲ]
забарані́ць	zabaranícʹ	[zabaraˈnʲit͡sʲ]
забаро́на	zabaróna	[zabaˈrona]
забо́йства	zabój	[zaˈbojstva]
за́йздрасць	-ascʹ	[ˈzajzdrasʲt͡sʲ]
займе́ннік	za-	[zajˈmʲenʲːik]
зако́н	zakón	[zaˈkon]
залаты́	zólata	[zaɫaˈtɨ]
незале́жны	njezaljéžny	[zaˈlʲeʐnɨ]
зало́жнік	zalóžnik	[zaˈɫoʐnʲik]
зало́жны	zalóžny	[zaˈɫoʐnɨ]
зало́за	žalóza	[zaˈɫoza]
за́мак	zámak	[ˈzamak]
заме́жны	za	[zaˈmʲeʐnɨ]
заме́ст	za	[zaˈmʲest]
запаве́т	zapavjét	[zapaˈvʲet]
запальні́чка	zapálʹvacʹ	[zapaˈlʲnʲit͡ʂka]
запэ́ўніць	za-	[zaˈpeu̯nʲit͡sʲ]
запя́сце	za-	[zaˈpʲasʲt͡sʲe]
заса́да	zasáda	[zaˈsada]
заты́м	zatým	[zaˈtɨm]
за́хад	záxad	[ˈzaxat]
захо́дні	záxad	[zaˈxodnʲi]
за́яц	zájac	[ˈzajat͡s]
збіра́ць	zbirácʹ	[zʲbʲiˈrat͡sʲ]
збе́жнасць	zbjéžny	[ˈzʲbʲeʐnasʲt͡sʲ]
звы́чай	zvýčaj	[ˈzvɨt͡ʂaj]
звыча́йны	zvýčaj	[zvɨˈt͡ʂajnɨ]
згі́нуць	s-	/ˈzɣʲinut͡sʲ/
згвалтава́ць	zhvalcícʹ	[zɡvaɫtaˈvat͡sʲ]
здаро́ўе	zdaróvy	[zdaˈrou̯je]
здаро́вы	zdaróvy	[zdaˈrovɨ]
здра́да	zdráda	[ˈzdrada]
зе́рне	zjérnje	[ˈzʲernʲe]
зло́дзей	zly	[ˈzɫod͡zʲej]
злу́чнік	zlučycʹ	[ˈzɫut͡ʂnʲik]
злы	zly	[zɫɨ]
змрок	zmrok	[zmrok]
змро́чны	zmrok	[ˈzmrot͡ʂnɨ]
змяя́	zmjajá	[zʲmʲaˈja]
зні́чка	zníčka	[ˈzʲnʲit͡ʂka]
знадво́рны	z-	[znaˈdvornɨ]
знак	znak	[znak]
зна́чыць	znak	[ˈznat͡ʂɨt͡sʲ]
значэ́нне	znáčycʹ	[znaˈt͡ʂenʲːe]
зноў	znoŭ	[znou̯]
зо́лата	placina	[ˈzoɫata]
зо́рка	zara	[ˈzorka]
зрок	zórak	[zrok]
зы́чны	zyk	[ˈzɨt͡ʂnɨ]
зялёны	zjaljóny	[zʲaˈlʲonɨ]
зямля́	zjamljá	[zʲaˈmlʲa]
й	j	/j/
кій	kij	[kʲij]
кінжа́л	kinžál	[kʲinˈʐaɫ]
кісларо́д	kísly	[kʲisɫaˈrot]
кі́слы	kísly	[ˈkʲisɫɨ]
кіт	kit	[kʲit]
кі́шка	kíška	[ˈkʲiʂka]
каўтун	kaŭtun	[kau̯tun]
каб	kab	[kap]
кабе́та	kabjéta	[kaˈbʲeta]
кабура́	kaburá	[kabuˈra]
кабы́ла	kabýla	[kaˈbɨɫa]
кава́дла	kuválda	[kaˈvadɫa]
каза́ць	kazácʹ	[kaˈzat͡sʲ]
калі́ ла́ска	kalí láska	[kaˈlʲi ˈɫaska]
калаўро́т	kalaŭrót	[kaɫau̯ˈrot]
кале́на	kaljéna	[kaˈlʲena]
калёсы	kóla	[kaˈlʲosɨ]
кало́дзеж	kalódzjež	[kaˈɫod͡zʲeʂ]
кало́ць	kalócʹ	[kaˈɫot͡sʲ]
калча́н	kalčán	[kaɫˈt͡ʂan]
калы́ска	kalýska	[kaˈɫɨska]
каля́ды	Kaljády	[kaˈlʲadɨ]
кама́р	kamár	[kaˈmar]
капы́т	kapýt	[kaˈpɨt]
капялю́ш	kapjaljúš	[kapʲaˈlʲuʂ]
кара́	kará	[kaˈra]
ка́рлік	kárlik	[ˈkarlʲik]
каро́ткі	karótki	[kaˈrotkʲi]
карчма́	karčmá	[karˈt͡ʂma]
кары́снасць	karýsny	[kaˈrɨsnasʲt͡sʲ]
кары́сны	karyscʹ	[kaˈrɨsnɨ]
кары́чневы	karýca	[kaˈrɨt͡ʂnʲevɨ]
каса́	kasá	[kaˈsa]
кат	kat	[kat]
катава́ць	katavácʹ	[kataˈvat͡sʲ]
каха́нне	kaxácʹ	[kaˈxanʲːe]
кацёл	kacjól	[kaˈt͡sʲoɫ]
ка́чка	káčka	[ˈkat͡ʂka]
качкано́с	káčka	[kat͡ʂkaˈnos]
кашто́ўны	kaštavácʹ	[kaˈʂtou̯nɨ]
кашу́ля	kašúlja	[kaˈʂulʲa]
кватэ́ра	kvatéra	[kvaˈtera]
ке́пскі	kjep	[ˈkʲepskʲi]
клі́каць	klíkacʹ	[ˈklʲikat͡sʲ]
клі́чнік	klíkacʹ	[ˈklʲit͡ʂnʲik]
кні́га	kníha	[ˈknʲiɣa]
князь	ksjondz	[knʲasʲ]
ко́жны	kóžny	[ˈkoʐnɨ]
ко́ла	kóla	[ˈkoɫa]
ко́лас	kólas	[ˈkoɫas]
ко́лер	kóljer	[ˈkolʲer]
ко́лькі	kólʹki	[ˈkolʲkʲi]
ко́лькасць	kólʹki	[ˈkolʲkasʲt͡sʲ]
ко́рань	kóranʹ	[ˈkoranʲ]
ко́ска	kóska	[ˈkoska]
косць	koscʹ	[kosʲt͡sʲ]
кошка	kóška	[ˈkoʂka]
край	kraj	[kraj]
кра́ма	kráma	[ˈkrama]
краяві́д	kraj	[krajaˈvʲit]
кро́пка	krópka	[ˈkropka]
крот	krot	[krot]
кру́глы	kruh	[ˈkruɣɫɨ]
круты́	krutý	[kruˈtɨ]
крывы́	kryvý	[krɨvɨ]
крыло́	kryló	[krɨˈɫo]
крэ́пасць	krépascʹ	[ˈkrepasʲt͡sʲ]
крэ́пкі	krépki	[ˈkrepkʲi]
крэ́сла	krésla	[ˈkresɫa]
ксёндз	knjazʹ	[ksʲont͡s]
куды́	kudý	[kuˈdɨ]
куды́сьці	kudý	[kuˈdɨsʲt͡sʲi]
кула́к	kulák	[kuˈɫak]
куса́ць	kusácʹ	[kuˈsat͡sʲ]
кут	kut	[kut]
ліса́	lisá	[lʲiˈsa]
ліст	list	[lʲist]
лі́чба	ličýcʹ	[ˈlʲid͡ʐba]
лічы́ць	lik	[lʲiˈt͡ʂɨt͡sʲ]
лаві́ць	lavícʹ	[ɫaˈvʲit͡sʲ]
ладдзя́	laddzjá	[ɫaˈd͡zʲːa]
ланцу́г	lancúh	[ɫanˈt͡sux]
ла́ска	láska	[ˈɫaska]
ласо́сь	lasósʹ	[ɫaˈsosʲ]
ле́бедзь	ljébjedzʹ	[ˈlʲebʲet͡sʲ]
лебядзі́ны	ljébjedzʹ	[lʲebʲaˈd͡zʲinɨ]
лёгкі	ljóhki	[ˈlʲoxkʲi]
лёд	ljod	[lʲot]
ле́пшы	ljépšy	[ˈlʲepʂɨ]
лёс	ljos	[lʲos]
лес	ljes	[lʲes]
ле́та	ljéta	[ˈlʲeta]
лоб	lob	[ɫop]
ло́жак	lóžak	[ˈɫoʐak]
ло́каць	lókacʹ	[ˈɫokat͡sʲ]
лук	luk	[ɫuk]
лы́жка	lýžka	[ˈɫɨʂka]
лы́сы	lýsy	[ˈɫɨsɨ]
лы́тка	lýtka	[ˈɫɨtka]
любо́ў	ljubóŭ	[lʲuˈbou̯]
лю́дзі	ljúdzi	[ˈlʲud͡zʲi]
людскі́	ljúdzi	[lʲuˈtskʲi]
люстэ́рка	ljústra	[lʲuˈsterka]
ляжа́ць	ljažácʹ	[lʲaˈʐat͡sʲ]
ляні́вы	ljanívy	[lʲaˈnʲivɨ]
міжнаро́дны	miž	[mʲiʐnaˈrodnɨ]
мілімэ́тар	mili-	[mʲilʲiˈmetar]
мі́лы	míly	[ˈmʲiɫɨ]
міну́лае	minúly	[mʲiˈnuɫaje]
міну́лы	minúcʹ	[mʲiˈnuɫɨ]
маўклі́вы	móŭknucʹ	[mau̯ˈklʲivɨ]
маўча́ць	maŭčácʹ	[mau̯ˈt͡ʂat͡sʲ]
магі́ла	mahíla	[maˈɣʲiɫa]
магній	mahnij	[maɣnʲij]
магу́тны	mahčý	[maˈɣutnɨ]
магчы́	mahčý	[maˈxt͡ʂɨ]
магчы́масць	mahčýmasʹcʹ	[maˈxt͡ʂɨmasʲt͡sʲ]
магчы́мы	mahčý	[maˈxt͡ʂɨmɨ]
маз	maz	[mas]
макры́ца	makrýca	[maˈkrɨt͡sa]
малі́тва	malítva	[maˈlʲitva]
малады́	maladý	[maɫaˈdɨ]
малако́	malakó	[maɫaˈko]
мала́нка	malánka	[maˈɫanka]
мале́нькі	maljénʹki	[maˈlʲenʲkʲi]
ма́лпа	málpa	[ˈmaɫpa]
малы́	malý	[maˈɫɨ]
маро́з	maróz	[maˈros]
мару́дны	marúdny	[maˈrudnɨ]
ма́сла	másla	[ˈmasɫa]
маста́к	masták	[maˈstak]
маста́цтва	masták	[maˈstat͡stva]
медзь	nikjelʹ	[mʲet͡sʲ]
ме́ншасць	mjénšasʹcʹ	[ˈmʲenʂasʲt͡sʲ]
мёртвы	mjórtvy	[ˈmʲortvɨ]
ме́сны	mjésta	[ˈmʲesnɨ]
ме́ста	mjésta	[ˈmʲesta]
ме́сца	mjésta	[ˈmʲest͡sa]
ме́сяц	týdzjenʹ	[ˈmʲesʲat͡s]
млын	mlyn	[mɫɨn]
мно́га	mnóha	[ˈmnoɣa]
мно́жны	mnóha	[ˈmnoʐnɨ]
но́вы	nóvy	[ˈnovɨ]
сусве́т	susvjét	[suˈsvʲet]
прына́мсі	u-	[prɨˈnamsʲi]
ве́льмі	vjélʹmi	[ˈvʲelʲmʲi]
ва́нна	vánna	[ˈvanːa]
капялю́ш	kapjaljúš	[kapʲaˈlʲuʂ]
сяке́ра	*sjakíra	[sʲaˈkʲera]
тапо́р	tapór	[taˈpor]
адзёр	adzjór	[aˈd͡zʲor]
тлума́ч	tlumáč	[tɫuˈmat͡ʂ]
сур'ёзны	surʺjózny	[suˈrjoznɨ]
Мсці́слаў	Mscíslaŭ	[ˈmsʲt͡sʲisɫau̯]
сталі́ца	stalíca	[staˈlʲit͡sa]
ша́бля	šáblja	[ˈʂablʲa]
сло́ўнік	slóva	[ˈsɫou̯nʲik]
белару́скі	bjelarúski	[bʲeɫaˈruskʲi]
ве́льмі	vjélʹmi	[ˈvʲelʲmʲi]
інцэ́ст	incést	[jinˈt͡sest]
каха́нне	kaxácʹ	[kaˈxanʲːe]
ко́жны	kóžny	[ˈkoʐnɨ]
мо́ва	móva	[ˈmova]
мо̀вазна́ўства	móva	[ˌmovaˈznau̯stva]
мозг	mózah	[mosk]
мо́кры	mókry	[ˈmokrɨ]
мо́ладзь	maladý	[ˈmoɫat͡sʲ]
мо́лат	mólat	[ˈmoɫat]
мо́рак	mrok	[ˈmorak]
мост	most	[most]
моц	moc	[mot͡s]
мо́цны	moc	[ˈmot͡snɨ]
Мсці́слаў	Mscíslaŭ	[ˈmsʲt͡sʲisɫau̯]
му́дры	múdry	[ˈmudrɨ]
муж	muž	[muʂ]
му́жнасць	múžnasʹcʹ	[ˈmuʐnasʲt͡sʲ]
мужчы́на	muž	[muˈʂt͡ʂɨna]
мужчы́нскі	mužčýna	[muˈʂt͡ʂɨnskʲi]
му́ляр	múljar	[ˈmulʲar]
мура́шнік	muráška	[muraʂnʲik]
мыш	myš	[mɨʂ]
мэ́тар	métar	[ˈmetar]
мядзве́дзь	mjadzʹvjédzʹ	[mʲaˈd͡zʲvʲet͡sʲ]
мяжа́	mjažá	[mʲaˈʐa]
мя́ккі	mjákki	[ˈmʲakʲːi]
мярэ́жа	mjaréža	[mʲaˈreʐa]
мя́са	mjása	[ˈmʲasa]
мятла́	mjatlá	[mʲaˈtɫa]
нідзе́	ni-	[nʲiˈd͡zʲe]
ні́зкі	nízki	[ˈnʲiskʲi]
ніко́лі	nikóli	[nʲiˈkolʲi]
нікуды́	ni-	[nʲikuˈdɨ]
ніхто́	ni-	[nʲiˈxto]
нішто́	ni-	[nʲiˈʂto]
ніякі́	ni-	[nʲijaˈkʲi]
наўмы́сны	naŭmýsny	[nau̯ˈmɨsnɨ]
наву́ка	navúka	[naˈvuka]
нагі́	nahí	[naˈɣʲi]
нага́	nahá	[naˈɣa]
нагаро́да	naharóda	[naɣaˈroda]
надзе́йны	nadzjéja	[naˈd͡zʲejnɨ]
надзе́я	nadzjéja	[naˈd͡zʲeja]
наздра́	nazdrá	[naˈzdra]
назо́ўнік	nazóŭ	[naˈzou̯nʲik]
назо́ўны	nazóŭ	[naˈzou̯nɨ]
найго́ршы	naj-	[najˈɣorʂɨ]
найле́пшы	naj-	[najˈlʲepʂɨ]
наме́р	namjér	[naˈmʲer]
напа́рстак	napárstak	[naˈparstak]
напры́клад	na	[naˈprɨkɫat]
напэ́ўна	péŭny	[naˈpeu̯na]
нара́	nará	[naˈra]
нара́да	na-	[naˈrada]
нарадзі́ць	na-	[naraˈd͡zʲit͡sʲ]
наро́д	naród	[naˈrot]
наро́дны	naród	[naˈrodnɨ]
насаро́г	nos	[nasaˈrox]
насе́нне	nasjénnje	[naˈsʲenʲːe]
наста́ўнік	nastáŭnik	[naˈstau̯nʲik]
насту́пства	nastúpstva	[naˈstupstva]
нато́ўп	natóŭp	[naˈtou̯p]
нашча́дак	naščádak	[naʂt͡ʂadak]
ная́ўны	najavje	[naˈjau̯nɨ]
не	nja	[nʲe]
неабве́ржны	nje-	[nʲeaˈbvʲerʐnɨ]
неабхо́дны	nje	[nʲeaˈpxodnɨ]
неадкла́дны	nje-	[nʲeaˈtkɫadnɨ]
не́ба	njóba	[ˈnʲeba]
небяспе́ка	njebjaspjéka	[nʲebʲaˈsʲpʲeka]
небяспе́чны	njebjaspjéka	[nʲebʲaˈsʲpʲet͡ʂnɨ]
недастатко́вы	nje-	[nʲedastaˈtkovɨ]
недахо́п	njedaxóp	[nʲedaˈxop]
незале́жнасць	njezaljéžny	[nʲezaˈlʲeʐnasʲt͡sʲ]
незале́жны	nje-	[nʲezaˈlʲeʐnɨ]
незвыча́йны	nje-	[nʲezvɨˈt͡ʂajnɨ]
ненадзе́йны	nje-	[nʲenaˈd͡zʲejnɨ]
непазбе́жны	nje-	[nʲepaˈzʲbʲeʐnɨ]
непаслушэ́нства	nje-	[nʲepasɫuˈʂenstva]
непасрэ́дны	nje-	[nʲepaˈsrednɨ]
непасці́жны	njepascížny	[nʲepaˈsʲt͡sʲiʐnɨ]
нетапы́р	njetapýr	[nʲetaˈpɨr]
не́хта	nje-	[ˈnʲexta]
нецярплі́вы	nje-	[nʲet͡sʲarˈplʲivɨ]
не́шта	nje-	[ˈnʲeʂta]
но́вы	nóvy	[ˈnovɨ]
нож	nož	[noʂ]
но́раў	nóraŭ	[ˈnorau̯]
ноч	noč	[not͡ʂ]
ны́рка	nýrka	[ˈnɨrka]
нюх	njux	[nʲux]
ню́хаць	njux	[ˈnʲuxat͡sʲ]
няві́нны	nja-	[nʲaˈvʲinːɨ]
нядзе́ля	njadzjélja	[nʲaˈd͡zʲelʲa]
нязгра́бны	nja-	[nʲaˈzɡrabnɨ]
нямы́	njamý	[nʲaˈmɨ]
нячу́тны	nja-	[nʲaˈt͡ʂutnɨ]
няшма́т	nja-	[nʲaˈʂmat]
піво́ня	pivónja	[pʲiˈvonʲa]
піла́	pilá	[pʲiˈɫa]
паўво́страў	paŭ-	[pau̯ˈvostrau̯]
паўднёвы	póŭdzjenʹ	[pau̯ˈdnʲovɨ]
паўно́чны	póŭnač	[pau̯ˈnot͡ʂnɨ]
пабачэ́нне	pabáčycʹ	[pabaˈt͡ʂenʲːe]
паві́нен	pavínjen	[paˈvʲinʲen]
паве́ка	pa-	[paˈvʲeka]
паве́тра	vjécjer	[paˈvʲetra]
паво́дзіны	pavódziny	[paˈvod͡zʲinɨ]
паво́льны	pavólʹny	[paˈvolʲnɨ]
паву́к	pavúk	[paˈvuk]
павуці́на	pavúk	[pavuˈt͡sʲina]
пага́рда	hórdy	[paˈɣarda]
пагарджа́ць	pahardžácʹ	[paɣarˈd͡ʐat͡sʲ]
пага́рдлівы	pahárda	[paˈɣardlʲivɨ]
паго́рак	pa-	[paˈɣorak]
пад	pad	[pat]
падаро́жжа	padaróžža	[padaˈroʐːa]
падару́нак	padarúnak	[padaˈrunak]
падбаро́дак	pad-	[padbaˈrodak]
падзе́йнічаць	pa-	[paˈd͡zʲejnʲit͡ʂat͡sʲ]
падзе́я	padzjéja	[paˈd͡zʲeja]
падле́так	pad-	[paˈdlʲetak]
падло́га	padlóha	[paˈdɫoɣa]
падпа́ха	padpáxa	[paˈtpaxa]
падсі́так	pad-	[paˈt͡sʲsʲitak]
пажа́р	pa-	[paˈʐar]
пажа́рышча	pažár	[paˈʐarɨʂt͡ʂa]
пазно́гаць	nóhacʹ	[paˈznoɣat͡sʲ]
пазы́чыць	pazýčycʹ	[paˈzɨt͡ʂɨt͡sʲ]
пако́рлівы	pakarácca	[paˈkorlʲivɨ]
паку́ль	pakúlʹ	[paˈkulʲ]
пакупні́к	kupícʹ	[pakuˈpnʲik]
паласа́	palasá	[paɫaˈsa]
палатно́	palatnó	[paɫaˈtno]
палахлі́вы	-lívy	[paɫaˈxlʲivɨ]
пале́на	paljéna	[paˈlʲena]
па́лец	páljec	[ˈpalʲet͡s]
пало́ва	palóva	[paˈɫova]
пало́н	palón	[paˈɫon]
пальча́тка	palʹčátka	[palʲˈt͡ʂatka]
паляўніцтвазна́ўства	paljaŭníctva	[palʲau̯nʲit͡stvaˈznau̯stva]
паляўні́чы	paljavácʹ	[palʲau̯ˈnʲit͡ʂɨ]
палява́ць	pólje	[palʲaˈvat͡sʲ]
памі́ж	pamíž	[paˈmʲiʂ]
памы́лка	pamýlka	[paˈmɨɫka]
памя́ць	pamjácʹ	[paˈmʲat͡sʲ]
панядзе́лак	panjadzjélak	[panʲaˈd͡zʲeɫak]
параўна́нне	paraŭnácʹ	[parau̯ˈnanʲːe]
параўна́ць	pa-	[parau̯ˈnat͡sʲ]
паражэ́нне	paražácʹ	[paraˈʐenʲːe]
паро́г	paróh	[paˈrox]
паро́жні	paróžni	[paˈroʐnʲi]
пасве́дчанне	pasvjédčycʹ	[paˈsʲvʲetː͡ʂanʲːe]
паслухмя́ны	sluxmjány	[pasɫuˈxmʲanɨ]
паслу́шны	paslúxacʹ	[paˈsɫuʂnɨ]
паслушэ́нства	paslúšny	[pasɫuˈʂenstva]
пасо́л	pasól	[paˈsoɫ]
патрабава́ць	patréba	[patrabaˈvat͡sʲ]
паты́ліца	patýlica	[paˈtɨlʲit͡sa]
пах	pax	[pax]
па́хнуць	pax	[ˈpaxnut͡sʲ]
пацу́к	pacúk	[paˈt͡suk]
пачва́рны	pačvárny	[paˈt͡ʂvarnɨ]
пачуццё	pačúcʹ	[pat͡ʂuˈt͡sʲːo]
пачу́ць	pačúcʹ	[paˈt͡ʂut͡sʲ]
Пенсільва́нія	Pjensilʹvánija	[pʲensʲiˈlʲvanʲija]
пень	pjenʹ	[pʲenʲ]
перава́га	pjera-	[pʲeraˈvaɣa]
пе́рад	pjérad	[ˈpʲerat]
перакла́д	pjeraklád	[pʲeraˈkɫat]
перакла́дчык	pjeraklád	[pʲeraˈkɫatː͡ʂɨk]
перамо́га	pjeramóha	[pʲeraˈmoɣa]
пе́рац	pjérac	[ˈpʲerat͡s]
печ	pječ	[pʲet͡ʂ]
пе́чань	pjéčanʹ	[ˈpʲet͡ʂanʲ]
пла́каць	plákacʹ	[ˈpɫakat͡sʲ]
плаці́на	placína	[pɫaˈt͡sʲina]
пло́скі	plóski	[ˈpɫoskʲi]
пло́шча	plóšča	[ˈpɫoʂt͡ʂa]
плуг	pluh	[pɫux]
плячо́	pljačó	[plʲaˈt͡ʂo]
по́ўдзень	póŭdzjenʹ	[ˈpou̯d͡zʲenʲ]
по́ўнач	póŭnač	[ˈpou̯nat͡ʂ]
по́ўны	póŭny	[ˈpou̯nɨ]
пол	pol	[poɫ]
по́лаз	pólaz	[ˈpoɫas]
по́ле	pólje	[ˈpolʲe]
по́лы	póly	[ˈpoɫɨ]
по́лымны	pólymja	[ˈpoɫɨmnɨ]
по́лымя	pólymja	[ˈpoɫɨmʲa]
по́мста	pómscicʹ	[ˈpomsta]
по́пел	pópjel	[ˈpopʲeɫ]
по́пельніца	pópjel	[ˈpopʲelʲnʲit͡sa]
по́рах	pórax	[ˈporax]
по́спех	póspjex	[ˈpospʲex]
пот	pot	[pot]
по́яс	pas	[ˈpojas]
пра́ўда	právy	[ˈprau̯da]
праўдашука́льнік	práŭda	[prau̯daʂuˈkalʲnʲik]
прабачэ́нне	prabáčycʹ	[prabaˈt͡ʂenʲːe]
прабле́ма	prabljéma	[praˈblʲema]
пра́віла	právila	[ˈpravʲiɫa]
праві́льны	právila	[praˈvʲilʲnɨ]
но́вы	nóvy	[ˈnovɨ]
сусве́т	susvjét	[suˈsvʲet]
прына́мсі	u-	[prɨˈnamsʲi]
ве́льмі	vjélʹmi	[ˈvʲelʲmʲi]
ва́нна	vánna	[ˈvanːa]
капялю́ш	kapjaljúš	[kapʲaˈlʲuʂ]
сяке́ра	*sjakíra	[sʲaˈkʲera]
тапо́р	tapór	[taˈpor]
адзёр	adzjór	[aˈd͡zʲor]
тлума́ч	tlumáč	[tɫuˈmat͡ʂ]
сур'ёзны	surʺjózny	[suˈrjoznɨ]
Мсці́слаў	Mscíslaŭ	[ˈmsʲt͡sʲisɫau̯]
сталі́ца	stalíca	[staˈlʲit͡sa]
ша́бля	šáblja	[ˈʂablʲa]
сло́ўнік	slóva	[ˈsɫou̯nʲik]
белару́скі	bjelarúski	[bʲeɫaˈruskʲi]
ве́льмі	vjélʹmi	[ˈvʲelʲmʲi]
інцэ́ст	incést	[jinˈt͡sest]
каха́нне	kaxácʹ	[kaˈxanʲːe]
ко́жны	kóžny	[ˈkoʐnɨ]
пра́ва	práva	[ˈprava]
пра́вапіс	právy	[ˈpravapʲis]
пра́дзед	pra-	[ˈprad͡zʲet]
пра́жа	práža	[ˈpraʐa]
празры́сты	pra-	[praˈzrɨstɨ]
пралетарыі ўсіх краін, яднайцеся!	praljetaryi ŭsix krain, jadnajcjesja!	[pralʲetarɨji wsʲix krajin jadnajt͡sʲesʲa]
праме́нь	pramjénʹ	[praˈmʲenʲ]
прамы́	pramý	[praˈmɨ]
прані́клівы	pranikácʹ	[praˈnʲiklʲivɨ]
прасі́ць	prasícʹ	[praˈsʲit͡sʲ]
пра́ца	práca	[ˈprat͡sa]
працаўні́к	pracavácʹ	[prat͡sau̯ˈnʲik]
працава́ць	práca	[prat͡saˈvat͡sʲ]
працо́ўны	pracavácʹ	[praˈt͡sou̯nɨ]
про́дак	pródak	[ˈprodak]
про́са	prósa	[ˈprosa]
про́сты	prósty	[ˈprostɨ]
проція́ддзе	jad	[prot͡sʲiˈjad͡zʲːe]
пру́ткі	prútki	[ˈprutkʲi]
пры	pry	[prɨ]
пры́від	prývid	[ˈprɨvʲit]
прывіта́нне	pryvitácʹ	[prɨvʲiˈtanʲːe]
прывіта́ць	pry-	[prɨvʲiˈtat͡sʲ]
прыгажо́сць	pryhažósʹcʹ	[prɨɣaˈʐosʲt͡sʲ]
прыгажу́н	pryhóžy	[prɨɣaˈʐun]
прыго́жы	pry-	[prɨˈɣoʐɨ]
прыда́тны	prydátny	[prɨˈdatnɨ]
пры́казка	prýkazka	[ˈprɨkaska]
пры́клад	prýklad	[ˈprɨkɫat]
прыме́тнік	prymjétnik	[prɨˈmʲetnʲik]
прыназо́ўнік	pry	[prɨnaˈzou̯nʲik]
прына́мсі	u-	[prɨˈnamsʲi]
прыро́да	pryróda	[prɨˈroda]
прыро́дны	pryróda	[prɨˈrodnɨ]
прысло́ўе	pry-	[prɨˈsɫou̯je]
прысу́тнасць	prysútny	[prɨˈsutnasʲt͡sʲ]
прысу́тны	prysútny	[prɨˈsutnɨ]
прыся́га	prysjáha	[prɨˈsʲaɣa]
прыту́лак	prytúlak	[prɨˈtuɫak]
прычы́на	pryčýna	[prɨˈt͡ʂɨna]
пры́яцель	prýjacjelʹ	[ˈprɨjat͡sʲelʲ]
прэсты́жны	prestýž	[preˈstɨʐnɨ]
пу́га	púha	[ˈpuɣa]
пу́дзіла	púdzila	[ˈpud͡zʲiɫa]
пурпу́рны	púrpur	[purˈpurnɨ]
пусты́	pustý	[puˈstɨ]
пусты́ня	pustý	[puˈstɨnʲa]
пчала́	pčalá	[pt͡ʂaˈɫa]
пшані́ца	pšanó	[pʂaˈnʲit͡sa]
пыл	pyl	[pɨɫ]
пыласо́с	pyl	[pɨɫaˈsos]
пыта́льнік	pytácʹ	[pɨˈtalʲnʲik]
пыта́ць	pytácʹ	[pɨˈtat͡sʲ]
пэ́ўны	péŭny	[ˈpeu̯nɨ]
пярдзе́ць	pjerdzjécʹ	[pʲarˈd͡zʲet͡sʲ]
пярсцёнак	pjérscjenʹ	[pʲarˈsʲt͡sʲonak]
пярэ́сты	pjarésty	[pʲaˈrestɨ]
пясо́к	pjasók	[pʲaˈsok]
пя́тка	-ka	[ˈpʲatka]
пятля́	pjatljá	[pʲaˈtlʲa]
пяча́ць	pjačácʹ	[pʲaˈt͡ʂat͡sʲ]
пячо́начны	pjačónka	[pʲaˈt͡ʂonat͡ʂnɨ]
пячо́ра	pjačóra	[pʲaˈt͡ʂora]
пяшчо́та	pjaščóta	[pʲaˈʂt͡ʂota]
рабі́ць	rabícʹ	[raˈbʲit͡sʲ]
рабро́	rabró	[raˈbro]
ра́дасны	rádascʹ	[ˈradasnɨ]
ра́дасць	rad	[ˈradasʲt͡sʲ]
радзі́ма	radzícca	[raˈd͡zʲima]
радзі́на	radzína	[raˈd͡zʲina]
ра́дыё	rádyjo	[ˈradɨjo]
размаўля́ць	razmóvicʹ	[razmau̯ˈlʲat͡sʲ]
размо́ва	raz-	[raˈzmova]
разуме́ць	razumjécʹ	[razuˈmʲet͡sʲ]
разу́мны	rózum	[raˈzumnɨ]
рака́	raká	[raˈka]
рапто́ўны	raptóŭny	[raˈptou̯nɨ]
расама́ха	rasamáxa	[rasaˈmaxa]
раско́ша	raskóša	[raˈskoʂa]
расчарава́ць	rasčaravácʹ	[raʂt͡ʂaraˈvat͡sʲ]
роў	rycʹ	[rou̯]
роўнабо́чны	róŭny	[rou̯naˈbot͡ʂnɨ]
ро́ўны	róŭny	[ˈrou̯nɨ]
род	rod	[rot]
ро́дны	rod	[ˈrodnɨ]
ро́зны	rózny	[ˈroznɨ]
ро́зум	rózum	[ˈrozum]
рот	rot	[rot]
ружо́вы	ružóvy	[ruˈʐovɨ]
ры́ба	rýba	[ˈrɨba]
рыдлёўка	rydljóŭka	[rɨˈdlʲou̯ka]
ры́ла	rýla	[rɨɫa]
рысь	rysʹ	[rɨsʲ]
рыць	rycʹ	[rɨt͡sʲ]
рэ́дкі	rédki	[ˈretkʲi]
рэ́шата	réšata	[ˈreʂata]
сі́ні	síni	[ˈsʲinʲi]
сі́та	síta	[ˈsʲita]
сабо́р	zbor	[saˈbor]
салаве́й	salavjéj	[saɫaˈvʲej]
сало́дкі	salódki	[saˈɫotkʲi]
сало́ма	salóma	[saˈɫoma]
самагу́бства	sam	[samaˈɣupstva]
самастрэ́л	sam	[samaˈstreɫ]
сапра́ўднае	sapráŭdny	[saˈprau̯dnaje]
сапра́ўдны	sapraŭdý	[saˈprau̯dnɨ]
сапраўды́	práŭda	[saprau̯ˈdɨ]
сарамлі́вы	sóram	[saraˈmlʲivɨ]
саро́ка	saróka	[saˈroka]
сачаві́ца	sačavíca	[sat͡ʂaˈvʲit͡sa]
свіне́ц	svinjéc	[sʲvʲiˈnʲet͡s]
свисто́к	svist	[sʲvʲiˈstok]
світа́нне	svitácʹ	[sʲvʲiˈtanʲːe]
свабо́да	svabóda	[svaˈboda]
свабо́дны	svabóda	[svaˈbodnɨ]
све́дка	svjédka	[ˈsʲvʲetka]
све́жы	sʹvjéžy	[ˈsʲvʲeʐɨ]
свёкар	svjókar	[ˈsʲvʲokar]
све́тлы	svjet	[ˈsʲvʲetɫɨ]
све́чка	svječá	[ˈsʲvʲet͡ʂka]
свякро́ў	svjakróŭ	[sʲvʲaˈkrou̯]
свякру́ха	svjakróŭ	[sʲvʲaˈkruxa]
свята́р	svjatý	[sʲvʲaˈtar]
святы́	svjatý	[sʲvʲaˈtɨ]
селязёнка	sjeljazjónka	[sʲelʲaˈzʲonka]
сёмы	sjem	[ˈsʲomɨ]
се́мя	sjémja	[ˈsʲemʲa]
се́на	sjéna	[ˈsʲena]
сёння	sjahónnja	[ˈsʲonʲːa]
серабро́	paládyj	[sʲeraˈbro]
серада́	sjeradá	[sʲeraˈda]
скі́віца	skívica	[ˈskʲivʲit͡sa]
склане́нне	sklanjácʹ	[skɫaˈnʲenʲːe]
ско́расць	skóry	[ˈskorasʲt͡sʲ]
скупы́	skupý	[skuˈpɨ]
ску́ра	škúra	[ˈskura]
слабы́	slabý	[sɫaˈbɨ]
сла́ва	sláva	[ˈsɫava]
слане́чнік	slanjéčnik	[sɫaˈnʲet͡ʂnʲik]
сле́сар	sljésar	[ˈsʲlʲesar]
сло́ўнік	slóva	[ˈsɫou̯nʲik]
сло́ўны	slóva	[ˈsɫou̯nɨ]
сло́ва	slóva	[ˈsɫova]
слуп	stoŭb	[sɫup]
слу́шнасць	slúšny	[ˈsɫuʂnasʲt͡sʲ]
сляза́	sljazá	[sʲlʲaˈza]
сляпы́	sljapý	[sʲlʲaˈpɨ]
смакта́ць	smaktácʹ	[smaktat͡sʲ]
сме́лы	smjecʹ	[ˈsʲmʲeɫɨ]
сме́цце	s-	[ˈsʲmʲet͡sʲːe]
смоўж	smoŭž	[smou̯ʂ]
снег	snjeh	[sʲnʲex]
сне́жань	sʹnjéžanʹ	[ˈsʲnʲeʐanʲ]
со́кал	sókal	[ˈsokaɫ]
со́лад	sólad	[ˈsoɫat]
сон	son	[son]
со́нца	sónca	[ˈsont͡sa]
со́рам	sóram	[ˈsoram]
спі́на	spína	[ˈsʲpʲina]
спабо́рніцтва	spabórnik	[spaˈbornʲit͡stva]
спадзява́цца	spadzjavácca	[spad͡zʲavat͡sːa]
спазні́цца	pózni	[spaˈzʲnʲit͡sːa]
спако́й	spakój	[spaˈkoj]
спако́йны	spakój	[spaˈkojnɨ]
спяко́тны	spjakóta	[sʲpʲaˈkotnɨ]
срэ́бра	sjerabró	[ˈsrebra]
ссаць	ssacʹ	[sːat͡sʲ]
стаго́ддзе	sto	[staˈɣod͡zʲːe]
сталі́ца	stalíca	[staˈlʲit͡sa]
стаме́ска	stamjéska	[staˈmʲeska]
Станіслаў	Stanislaŭ	[stanʲiˈsɫau̯]
старана́	staraná	[staraˈna]
стары́	starý	[staˈrɨ]
ствол	stvol	[stvoɫ]
стол	stol	[stoɫ]
сто́раж	stóraž	[ˈstoraʂ]
стра́ўнік	stráŭnik	[ˈstrau̯nʲik]
страла́	stralá	[straˈɫa]
страля́ць	stralá	[straˈlʲat͡sʲ]
стрэл	strélicʹ	[streɫ]
стрэ́ліць	stralá	[ˈstrelʲit͡sʲ]
стрэ́льба	strélicʹ	[ˈstrelʲba]
ступе́нь	stupjénʹ	[stuˈpʲenʲ]
суддзя́	suddzjá	[suˈd͡zʲːa]
сумле́нны	sumljénny	[suˈmlʲenːɨ]
су́мны	sum	[ˈsumnɨ]
супрацо́ўніцтва	su-	[supraˈt͡sou̯nʲit͡stva]
су́праць	súpracʹ	[ˈsuprat͡sʲ]
сур'ёзны	surʺjózny	[suˈrjoznɨ]
сусве́т	susvjét	[suˈsvʲet]
сусе́д	susjéd	[suˈsʲet]
сухі́	suxí	[suˈxʲi]
суча́сны	su-	[suˈt͡ʂasnɨ]
сці́плы	scíply	[ˈsʲt͡sʲipɫɨ]
сцябло́	scjabló	[sʲt͡sʲaˈbɫo]
сцяг	scjah	[sʲt͡sʲax]
сцягно́	sʹcjahnó	[sʲt͡sʲaˈɣno]
сцяна́	scjaná	[sʲt͡sʲaˈna]
сэ́рца	sérca	[ˈsert͡sa]
ся́бар	sjábar	[ˈsʲabar]
но́вы	nóvy	[ˈnovɨ]
сусве́т	susvjét	[suˈsvʲet]
прына́мсі	u-	[prɨˈnamsʲi]
ве́льмі	vjélʹmi	[ˈvʲelʲmʲi]
ва́нна	vánna	[ˈvanːa]
капялю́ш	kapjaljúš	[kapʲaˈlʲuʂ]
сяке́ра	*sjakíra	[sʲaˈkʲera]
тапо́р	tapór	[taˈpor]
адзёр	adzjór	[aˈd͡zʲor]
тлума́ч	tlumáč	[tɫuˈmat͡ʂ]
сур'ёзны	surʺjózny	[suˈrjoznɨ]
Мсці́слаў	Mscíslaŭ	[ˈmsʲt͡sʲisɫau̯]
сталі́ца	stalíca	[staˈlʲit͡sa]
ша́бля	šáblja	[ˈʂablʲa]
сло́ўнік	slóva	[ˈsɫou̯nʲik]
белару́скі	bjelarúski	[bʲeɫaˈruskʲi]
ве́льмі	vjélʹmi	[ˈvʲelʲmʲi]
інцэ́ст	incést	[jinˈt͡sest]
каха́нне	kaxácʹ	[kaˈxanʲːe]
ко́жны	kóžny	[ˈkoʐnɨ]
сяго́ння	sjahónnja	[sʲaˈɣonʲːa]
сядло́	sjadló	[sʲaˈdɫo]
сяке́ра	*sjakíra	[sʲaˈkʲera]
сярдзі́ты	sjardzíty	[sʲarˈd͡zʲitɨ]
сяро́д	sjeradá	[sʲaˈrot]
сярэ́браны	sjerabró	[sʲaˈrebranɨ]
сястра́	sjastrá	[sʲaˈstra]
сятча́тка	sjetka	[sʲaˈtː͡ʂatka]
тава́р	tavár	[taˈvar]
тава́рыш	taváryš	[taˈvarɨʂ]
тады́	tadý	[taˈdɨ]
та́нны	tánny	[ˈtanːɨ]
тапо́р	tapór	[taˈpor]
таямні́ца	tajamníca	[tajaˈmnʲit͡sa]
твар	tvar	[tvar]
тво́рны	tvarýcʹ	[ˈtvornɨ]
тка́цтва	tkacʹ	[ˈtkat͡stva]
тлума́ч	tlumáč	[tɫuˈmat͡ʂ]
тлу́сты	tóŭsty	[ˈtɫustɨ]
то́ўсты	tlústy	[ˈtou̯stɨ]
той	toj	[toj]
то́лькі	tólʹki	[ˈtolʲkʲi]
то́нкі	tónki	[ˈtonkʲi]
тра́ктар	tráktar	[ˈtraktar]
трохвуго́льнік	try	[troxvuˈɣolʲnʲik]
труна́	truná	[truˈna]
трус	trus	[trus]
тру́цень	trúcjenʹ	[ˈtrut͡sʲenʲ]
трыма́ць	trymácʹ	[trɨˈmat͡sʲ]
трыснёг	trysnjóh	[trɨˈsʲnʲox]
туале́т	tualjét	[tuaˈlʲet]
тугі́	tuhí	[tuˈɣʲi]
тупы́	tupý	[tuˈpɨ]
тут	tut	[tut]
ты́дзень	dzjenʹ	[ˈtɨd͡zʲenʲ]
тысячаго́ддзе	týsjača	[tɨsʲat͡ʂaˈɣod͡zʲːe]
ува́га	uváha	[uˈvaɣa]
удзя́чны	ŭdzjáčny	[uˈd͡zʲat͡ʂnɨ]
ужо́	ŭžo	[uˈʐo]
узро́вень	róŭny	[uˈzrovʲenʲ]
уключа́ць	ŭključácʹ	[uklʲuˈt͡ʂat͡sʲ]
ула́да	ŭlada	[uˈɫada]
Уладзі́мер	Ŭladzímjer	[uɫaˈd͡zʲimʲer]
ула́сны	ulásny	[uˈɫasnɨ]
умо́ва	umóva	[uˈmova]
уну́к	unúk	[uˈnuk]
уну́траны	unútrany	[uˈnutranɨ]
упа́рты	ŭpárty	[uˈpartɨ]
упершыню́	u-	[upʲerʂɨˈnʲu]
уплы́ў	ŭplyŭ	[uˈpɫɨu̯]
уплыво́вы	uplýŭ	[upɫɨˈvovɨ]
ура́д	ŭrad	[uˈrat]
уража́льны	uražácʹ	[uraˈʐalʲnɨ]
уража́нне	uražácʹ	[uraˈʐanʲːe]
усё	ŭsjo	[uˈsʲo]
усе́	ŭsje	[uˈsʲe]
усеагу́льны	ŭsjeahúlʹny	[usʲeaˈɣulʲnɨ]
усёмагу́тны	usjó	[usʲomaˈɣutnɨ]
усхо́д	ŭsxod	[uˈsxot]
усю́ды	usjé	[uˈsʲudɨ]
ухілі́цца	ŭxilícca	[uxʲiˈlʲit͡sːa]
учо́ра	ŭčóra	[uˈt͡ʂora]
фіяле́тавы	fijaljétavy	[fʲijaˈlʲetavɨ]
фах	fax	[fax]
хі́тры	xítry	[ˈxʲitrɨ]
Ха́ва	Xáva	[ˈxava]
хадзі́ць	xadzícʹ	[xaˈd͡zʲit͡sʲ]
халадзі́льнік	xaladzícʹ	[xaɫaˈd͡zʲilʲnʲik]
хало́дны	xólad	[xaˈɫodnɨ]
харо́бры	xrábry	[xaˈrobrɨ]
хаце́ць	xacjécʹ	[xaˈt͡sʲet͡sʲ]
хва́ля	xválja	[ˈxvalʲa]
хваро́ба	xvóry	[xvaˈroba]
хво́раст	xvórast	[ˈxvorast]
хво́ры	xvóry	[ˈxvorɨ]
хвост	xvost	[xvost]
хма́ра	xmára	[ˈxmara]
хо́лад	xólad	[ˈxoɫat]
хрушч	xrušč	[xruʂt͡ʂ]
хто	xto	[xto]
худы́	xudý	[xuˈdɨ]
ху́ткі	xútki	[ˈxutkʲi]
ці	ci	[t͡sʲi]
ці́хі	cíxi	[ˈt͡sʲixʲi]
цана́	caná	[t͡saˈna]
цвёрды	cvjórdy	[ˈt͡sʲvʲordɨ]
цвяро́зы	cʹvjarózy	[t͡sʲvʲaˈrozɨ]
це́ла	cjéla	[ˈt͡sʲeɫa]
цёмны	cjómny	[ˈt͡sʲomnɨ]
це́мя	cjémja	[ˈt͡sʲemʲa]
цёплы	cjóply	[ˈt͡sʲopɫɨ]
це́сны	cjésny	[ˈt͡sʲesnɨ]
це́ста	cjésta	[t͡sʲesta]
цнатлі́вы	cnóta	[t͡snaˈtlʲivɨ]
цно́та	cnóta	[ˈt͡snota]
цуд	cud	[t͡sut]
цыбу́ля	cybúlja	[t͡sɨˈbulʲa]
цыгарэ́та	cyharéta	[t͡sɨɣaˈreta]
цыру́льнік	-nik	[t͡sɨˈrulʲnʲik]
цыру́льня	-nja	[t͡sɨˈrulʲnʲa]
цэ́лы	cély	[ˈt͡seɫɨ]
цюле́нь	cjuljénʹ	[t͡sʲuˈlʲenʲ]
цяга́ць	cjahácʹ	[t͡sʲaˈɣat͡sʲ]
ця́жар	cjažkí	[ˈt͡sʲaʐar]
цяжа́рны	cjažár	[t͡sʲaˈʐarnɨ]
цяжкі́	cjažkí	[ˈt͡sʲaʂkʲi]
цяля́	cjaljá	[t͡sʲaˈlʲa]
цяпло́	cjóply	[t͡sʲaˈpɫo]
цярплі́вы	cjarpjécʹ	[t͡sʲarˈplʲivɨ]
цясла́	cjaslá	[ˈt͡sʲasɫa]
чака́ць	čakácʹ	[t͡ʂaˈkat͡sʲ]
чалаве́к	čalavjék	[t͡ʂaɫaˈvʲek]
чалаве́цтва	čalavjék	[t͡ʂaɫaˈvʲet͡stva]
чалаве́чы	čalavjék	[t͡ʂaɫaˈvʲet͡ʂɨ]
чало́	čaló	[t͡ʂaˈɫo]
чаму́	čamú	[t͡ʂaˈmu]
чараўні́к	čáry	[t͡ʂarau̯ˈnʲik]
чараві́к	čaravíki	[t͡ʂaraˈvʲik]
чарапа́ха	čarapáxa	[t͡ʂaraˈpaxa]
чаро́мха	čarómuxa	[t͡ʂaˈromxa]
чарот	čarót	[t͡ʂaˈrot]
чарпа́к	čarpák	[t͡ʂarˈpak]
чарэ́шня	čaréšnja	[t͡ʂaˈreʂnʲa]
ча́сам	čásam	[ˈt͡ʂasam]
часно́к	časnók	[t͡ʂaˈsnok]
ча́ста	částy	[ˈt͡ʂasta]
ча́стка	čascʹ	[ˈt͡ʂastka]
ча́сты	částy	[ˈt͡ʂastɨ]
чаты́ры	čatyry	[t͡ʂaˈtɨrɨ]
чацвёрты	čatýry	[t͡ʂaˈt͡sʲvʲortɨ]
чо́вен	čóvjen	[ˈt͡ʂovʲen]
чо́рны	čórny	[ˈt͡ʂornɨ]
чужазе́мны	čužý	[t͡ʂuʐaˈzʲemnɨ]
чужы́	čužý	[t͡ʂuˈʐɨ]
чу́тны	čucʹ	[ˈt͡ʂutnɨ]
чуць	čucʹ	[t͡ʂut͡sʲ]
чырво́ны	čyrvóny	[t͡ʂɨˈrvonɨ]
чы́сты	čýsty	[ˈt͡ʂɨstɨ]
чыта́ць	čytácʹ	[t͡ʂɨˈtat͡sʲ]
чэ́рава	čérava	[ˈt͡ʂerava]
чэ́рап	čérap	[ˈt͡ʂerap]
чэ́рвень	czerwień	[ˈt͡ʂervʲenʲ]
чэсць	čescʹ	[t͡ʂesʲt͡sʲ]
ш	š	[ʂ]
ша́бля	šáblja	[ˈʂablʲa]
шалёны	šaljóny	[ʂaˈlʲonɨ]
шало́м	šalóm	[ʂaˈɫom]
ша́пка	šápka	[ˈʂapka]
шкіле́т	škiljét	[ʂkʲiˈlʲet]
шкадава́ць	škadavácʹ	[ʂkadaˈvat͡sʲ]
шкло	šklo	[ʂkɫo]
шко́да	škóda	[ˈʂkoda]
шлюб	šljub	[ʂlʲup]
шлях	šljax	[ʂlʲax]
шмат	šmat	[ʂmat]
шоўк	šoŭk	[ʂou̯k]
шру́ба	šrúba	[ˈʂruba]
што	što	[ʂto]
што́сьці	štosʹ	[ˈʂtosʲt͡sʲi]
шту́рхаць	štúrxacʹ	[ˈʂturxat͡sʲ]
шука́льнік	šukácʹ	[ʂuˈkalʲnʲik]
шука́ць	šukácʹ	[ʂuˈkat͡sʲ]
шчака́	ščaká	[ʂt͡ʂaˈka]
шчаслі́вы	ščáscje	[ʂt͡ʂaˈsʲlʲivɨ]
шча́сце	ščáscje	[ˈʂt͡ʂasʲt͡sʲe]
шчо́дры	ščódry	[ˈʂt͡ʂodrɨ]
шчы́льны	ščelʹ	[ˈʂt͡ʂɨlʲnɨ]
шчы́ры	ščýry	[ˈʂt͡ʂɨrɨ]
шчыт	ščyt	[ʂt͡ʂɨt]
шы́беніца	šýbjenica	[ˈʂɨbʲenʲit͡sa]
шырата́	šyróki	[ʂɨraˈta]
шыро́кі	šyróki	[ʂɨˈrokʲi]
шыць	šycʹ	[ʂɨt͡sʲ]
шэ́ршань	šéršanʹ	[ˈʂerʂanʲ]
шэ́ры	sjéry	[ˈʂerɨ]
ы	y	[ɨ]
эпістэмало́гія	epistemaljóhija	[epʲistemaˈɫoɣʲija]
этымало́гія	etymaljóhija	[etɨmaˈɫoɣʲija]
ю́ны	júny	[ˈjunɨ]
яба́ць	jabácʹ	[jaˈbat͡sʲ]
я́блык	jáblyk	[ˈjabɫɨk]
я́гада	jáhada	[ˈjaɣada]
ягня́	jahnjá	[jaˈɣnʲa]
я́драны	jadró	[ˈjadranɨ]
язы́к	jazýk	[jaˈzɨk]
я́йка	jájka	[ˈjajka]
яйцо́	jajcó	[jajˈt͡so]
які́	jakí	[jaˈkʲi]
я́касць	jakí	[ˈjakasʲt͡sʲ]
Япо́нія	Japónija	[jaˈponʲija]
я́ркі	járki	[ˈjarkʲi]
ярмо́	jarmó	[jaˈrmo]
я́сны	jásny	[ˈjasnɨ]
я́страб	jástrab	[ˈjastrap]
ячме́нь	jačmjénʹ	[jaˈt͡ʂmʲenʲ]
я́шчарка	-ka	[ˈjaʂt͡ʂarka]
яшчэ́	jaščé	[jaʂt͡ʂe]
