krowach	/Ëˆkrowax/
krowami	/ˈkrowamʲi/
krowy	/ˈkrowɨ/
Šwikawa	/ˈʃvʲikawa/
Mišnjo	/ˈmʲiʃnʲɔ/
Kamjenica	/ˈkamʲɛnʲit͡sa/
Frankobrod nad Odru	/ˈfrankɔbrɔt ˈnadɔdru/
ježe	/ˈjɛʒɛ/
Česka	/ˈtʃɛska/
Sakska	/ˈsakska/
bananu	/baˈnanu/
kobru	/ˈkɔbru/
kobry	/ˈkɔbrɨ/
kobrami	/ˈkɔbramʲi/
bruse	/ˈbrusɛ/
drapa	[ˈdrapa]
carna	[ˈt͡sarna]
duj	[duj]
ceje	/ˈt͡sɛjɛ/
segni	[ˈsɛɡnʲi]
a	[a]
abo	/ˈabɔ/
absolwent	/apsɔlˈvɛnt/
absolwentka	/apsɔlˈvɛntka/
aby	[ˈabɨ]
adresa	[aˈdrɛsa]
Afrika	/ˈafrʲika/
ako	/ˈakɔ/
Albanarka	/alˈbanarka/
Albanaŕ	/alˈbanarʲ/
ale	/ˈalɛ/
Alojs	/ˈalɔjs/
-arka	[arka]
-aŕ	/arʲ/
Awstriska	/ˈawstrʲiska/
awto	/ˈawtɔ/
awtor	/ˈawtɔr/
Azija	/ˈazija/
až	[aʃ]
baba	/ˈbaba/
babam	[Ëˆbabam]
babce	/ˈbapt͡sɛ/
babka	[ˈbapka]
babkach	[Ëˆbapkax]
babkami	[ˈbapkamʲi]
babki	[ˈbapkʲi]
babu	[Ëˆbabu]
baby	/ˈbabɨ/
badak	[ˈbadak]
bakany	[ˈbakanɨ]
banana	/baˈnana/
bananu	/baˈnanu/
banka	/ˈbanka/
bankach	/ˈbankax/
bankami	/ˈbankamʲi/
banki	/ˈbankʲi/
banku	/ˈbanku/
baran	[ˈbaran]
barana	/ˈbarana/
Barlinja	/ˈbarlʲinʲa/
Barliń	/ˈbarlʲinʲ/
barwa	/ˈbarva/
baz	/bas/
baza	/Ëˆbaza/
baze	/ˈbazɛ/
bazowy	/ˈbazɔwɨ/
bazu	[ˈbazu]
bcha	/pxa/
beja	/ˈbɛja/
bejach	/ˈbɛjax/
běch	/bʲɪx/
běchmej	/ˈbʲɪxmej/
běchmy	/ˈbʲɪxmɨ/
běchu	/ˈbʲɪxu/
běły	/ˈbʲɪwɨ/
běšćo	/ˈbʲɪɕt͡ɕɔ/
běšo	/ˈbʲɪʃɔ/
běštej	/ˈbʲɪʃtej/
běžaś	/ˈbʲɪʒaɕ/
bij	[bʲij]
biju	[ˈbʲiju]
bił	[ˈbʲiw]
bili	[ˈbʲilʲi]
biś	[bʲiɕ]
bit	/bʲit/
bjachaŕ	/ˈbʲaxarʲ/
b́edro	/ˈbʲɛdrɔ/
bjerjech	/ˈbʲɛrʲɛç/
bjerjechmej	/ˈbʲɛrʲɛçmɛj/
bjerjechmy	/ˈbʲɛrʲɛçmɨ/
bjerjechu	/ˈbʲɛrʲɛçu/
bjerjecy	/ˈbʲɛrʲɛt͡sɨ/
bjerješćo	/ˈbʲɛrʲɛɕt͡ɕɔ/
bjerješo	/ˈbʲɛrʲɛʃɔ/
bjerještej	/ˈbʲɛrʲɛʃtɛj/
bjerjo	/ˈbʲɛrʲɔ/
bjerjom	/ˈbʲɛrʲɔm/
bjerjomej	/ˈbʲɛrʲɔmɛj/
bjerjomy	/ˈbʲɛrʲɔmɨ/
bjerjoš	/ˈbʲɛrʲɔʃ/
bjerjośo	/ˈbʲɛrʲɔɕɔ/
bjerjotej	/ˈbʲɛrʲɔtɛj/
bjeru	[ˈbʲeru]
bjerucy	[ˈbʲerutsɨ]
bjeŕ	/bʲɛrʲ/
bjeŕśo	/ˈbʲɛrʲɕɔ/
bjeŕtej	/ˈbʲɛrʲtɛj/
błogi	/ˈbɔɡʲi/
Błota	/ˈbwɔta/
błoto	/ˈbwɔtɔ/
blědy	/ˈblɪdɨ/
blida	/ˈblida/
blido	/ˈblidɔ/
bliska	/ˈbliska/
bliski	/ˈbliskʲi/
bliskich	/ˈbliskʲix/
bliskim	/ˈbliskʲim/
bliskimi	/ˈbliskʲimʲi/
blisko	/ˈbliskɔ/
bluwa	[ˈbluwa]
bluwaju	[ˈbluwaju]
bluwał	[ˈbluwaw]
bluwam	[ˈbluwam]
bluwaś	[ˈbluwaɕ]
bob	/bɔp/
boba	[ˈbɔba]
bobr	/bɔbr/
boce	/ˈbɔt͡sɛ/
bog	[bɔk]
Bog	[bɔk]
boga	/ˈbɔɡa/
bogaty	/ˈbɔɡatɨ/
bogi	[ˈbɔɡʲi]
bogojski	[ˈbɔɡɔjski]
bój	/bɛj/
bójał	/ˈbɛjaw/
bójaś	/ˈbɛjaɕ/
bóje	/ˈbɛjɛ/
bójm	/bɛjm/
bok	/bɔk/
boka	[ˈbɔka]
boki	[ˈbɔkʲi]
bokom	[ˈbɔkɔm]
boku	[ˈbɔku]
ból	/bɨl/
bóleł	/ˈbɨlɛw/
bóleś	/ˈbɨlɛɕ/
bóli	/ˈbɨli/
bom	/bɔm/
boma	/ˈbɔma/
bomoju	[ˈbɔmɔju]
bósučki	/ˈbɨsut͡ʃki/
bósy	/ˈbɨsɨ/
bóžy	/ˈbɨʒɨ/
brał	[ˈbraw]
brała	[ˈbrawa]
brałej	[ˈbrawej]
brało	[ˈbrawɔ]
brali	[ˈbralʲi]
Bramborska	/ˈbrambɔrska/
brana	[Ëˆbrana]
brane	/ˈbranɛ/
branu	[ˈbranu]
brany	[ˈbranɨ]
braś	/braɕ/
brat	[brat]
bratš	/bratʃ/
bridki	/ˈbrʲitkʲi/
brjaza	/ˈbrʲaza/
brjaze	/ˈbrʲazɛ/
brjog	[brʲɔk]
brjogu	[ˈbrʲɔɡu]
brjoze	/ˈbrʲɔzɛ/
brjuch	/brʲux/
brod	/brɔt/
broda	/ˈbrɔda/
brodach	/ˈbrɔdax/
brodami	/ˈbrɔdamʲi/
brodom	/ˈbrɔdɔm/
brodu	/ˈbrɔdu/
brody	[ˈbrɔdɨ]
brona	/ˈbrɔna/
brony	[ˈbrɔnɨ]
broń	/brɔnʲ/
brošma	/ˈbrɔʃma/
brudny	[ˈbrudnɨ]
bruk	/bruk/
bruka	[Ëˆbruka]
bruku	[Ëˆbruku]
brus	[brus]
brusa	[Ëˆbrusa]
bruse	/ˈbrusɛ/
brusk	[brusk]
bubon	/ˈbubɔn/
buch	[bux]
buchmej	[ˈbuxmej]
buchmy	[ˈbuxmɨ]
buchu	[ˈbuxu]
buda	[ˈbuda]
budka	[ˈbutka]
budu	[ˈbudu]
buducy	/ˈbudut͡sɨ/
Budyšyn	/ˈbudɨʃɨn/
bujny	/ˈbujnɨ/
buk	/buk/
buka	[Ëˆbuka]
buki	[ˈbukʲi]
buku	[Ëˆbuku]
Bulgarska	[ˈbulɡarska]
bušćo	[ˈbuɕt͡ɕɔ]
buštej	[ˈbuʃtej]
butra	/ˈbutra/
buwoł	/ˈbuwɔw/
buź	/buɕ/
buźćo	/ˈbuɕt͡ɕɔ/
buźo	[ˈbuʑɔ]
buźom	/ˈbuʑɔm/
buźomej	[ˈbuʑɔmej]
buźomy	[ˈbuʑɔmɨ]
buźoš	[ˈbuʑɔʃ]
krowach	/Ëˆkrowax/
krowami	/ˈkrowamʲi/
krowy	/ˈkrowɨ/
Šwikawa	/ˈʃvʲikawa/
Mišnjo	/ˈmʲiʃnʲɔ/
Kamjenica	/ˈkamʲɛnʲit͡sa/
Frankobrod nad Odru	/ˈfrankɔbrɔt ˈnadɔdru/
ježe	/ˈjɛʒɛ/
Česka	/ˈtʃɛska/
Sakska	/ˈsakska/
bananu	/baˈnanu/
kobru	/ˈkɔbru/
kobry	/ˈkɔbrɨ/
kobrami	/ˈkɔbramʲi/
bruse	/ˈbrusɛ/
drapa	[ˈdrapa]
carna	[ˈt͡sarna]
duj	[duj]
ceje	/ˈt͡sɛjɛ/
segni	[ˈsɛɡnʲi]
buźośo	[ˈbuʑɔɕɔ]
buźotej	[ˈbuʑɔtej]
buźtej	/ˈbuɕtɛj/
by	[bɨ]
bydle	/ˈbɨdlɛ/
bydlenje	/ˈbɨdlɛnʲɛ/
bydleńska śpa	[ˈbɨdlenʲska ˈɕpa]
bydleński	[ˈbɨdlenʲskʲi]
bydli	/ˈbɨdli/
bydlił	/ˈbɨdliw/
bydlim	/ˈbɨdlim/
bydliś	/ˈbɨdliɕ/
bydlit	/ˈbɨdlit/
byk	/bɨk/
był	[bɨw]
była	[ˈbɨwa]
byłej	/ˈbɨwej/
było	[ˈbɨwɔ]
byli	/ˈbɨli/
byśe	/ˈbɨɕɛ/
byt	[bɨt]
bźez	/bʑɛs/
candaŕ	/ˈt͡sandarʲ/
capla	/ˈt͡sapla/
caple	/ˈt͡saplɛ/
carna	[ˈt͡sarna]
carne	/ˈt͡sarnɛ/
carnem	/ˈt͡sarnɛm/
carnica	[ˈtsarnʲitsa]
carny	[ˈtsarnɨ]
cas	/t͡sas/
casa	/ˈt͡sasa/
casam	[ˈt͡sasam]
case	/ˈt͡sasɛ/
casnik	[ˈt͡sasnʲik]
casu	[ˈt͡sasu]
ceja	/ˈt͡sɛja/
ceje	/ˈt͡sɛjɛ/
ceji	/ˈt͡sɛji/
ceło	/ˈt͡sɛwɔ/
ceły	[ˈtsɛwɨ]
cele	/ˈt͡sɛlɛ/
cep	[t͡sɛp]
cepam	[ˈt͡sɛpam]
ceptaŕ	/ˈt͡sɛptarʲ/
cepy	[ˈtsɛpɨ]
cerkwja	[ˈt͡sɛrkvʲa]
cerw	/t͡sɛrf/
cerwjeny	/ˈt͡sɛrvʲɛnɨ/
cesa	/ˈt͡sɛsa/
cesaś	[ˈtsɛsaɕ]
cesć	/t͡sɛst͡ɕ/
cesta	/ˈt͡sɛsta/
ceste	[ˈt͡sɛstɛ]
cesto	/ˈt͡sɛstɔ/
cesty	/ˈt͡sɛstɨ/
chart	[xart]
charta	/Ëˆxarta/
chartam	[ˈxartam]
chłodno	/ˈxɔdnɔ/
chłodny	/ˈxɔdnɨ/
chlěw	/xlɪw/
chójźiś	/ˈxɛjʑiɕ/
chołuj	[ˈxowuj]
chóra	/ˈxɨra/
chóre	/ˈxɨrɛ/
chórem	/ˈxɨrɛm/
chórgoj	/ˈxɨrɡɔj/
chórobna sotša	/ˈxɨrɔbna ˈsɔt͡ʃa/
chórobny	/ˈxɨrɔbnɨ/
chórowni	/ˈxɨrownʲi/
chórownja	/ˈxɨrownʲa/
chóry	/ˈxɨrɨ/
chórych	/ˈxɨrɨx/
Chóśebuski	/ˈxɛɕɛbuskʲi/
Chóśebuz	/ˈxɛɕɛbus/
Chóśebuza	/ˈxɛɕɛbuza/
chrobry	/ˈxrɔbrɨ/
chroma	/ˈxrɔma/
chrome	/ˈxrɔmɛ/
chromy	/ˈxrɔmɨ/
chrust	/xrust/
chto	/xtɔ/
chudy	/ˈxudɨ/
chyle	[ˈxɨlɛ]
chyliś	/ˈxɨliɕ/
chytaś	[ˈxɨtaɕ]
chytat	[ˈxɨtat]
chytšy	/ˈxɨtʃɨ/
cłowjek	/ˈt͡swɔvʲɛk/
co	/t͡sɔ/
cogo	/ˈt͡sɔɡɔ/
cołn	[tsown]
coło	[ˈtsowɔ]
cole	/ˈt͡sɔlɛ/
com	[t͡sɔm]
comu	/ˈt͡sɔmu/
comy	[ˈt͡sɔmɨ]
cora	/ˈt͡sɔra/
coš	/t͡sɔʃ/
což	/t͡sɔʃ/
crjej	/t͡srʲɛj/
crjono	[ˈtsrʲɔnɔ]
crjop	/t͡srʲɔp/
crjowo	[ˈt͡srʲowɔ]
cu	[t͡su]
cujo	[ˈt͡sujɔ]
cuju	[ˈt͡suju]
cukor	/ˈt͡sukɔr/
cuś	[tsuɕ]
cut	/t͡sut/
cuzy	/ˈt͡suzɨ/
cybula	[ˈt͡sɨbula]
cycaś	[ˈtsɨtsaɕ]
cyni	/ˈt͡sɨnʲi/
cynił	/ˈt͡sɨnʲiw/
cynim	/ˈt͡sɨnʲim/
cynimej	/ˈt͡sɨnʲimej/
cynimy	/ˈt͡sɨnʲimɨ/
cyniš	/ˈt͡sɨnʲiʃ/
cyniś	/ˈt͡sɨnʲiɕ/
cyniśo	/ˈt͡sɨnʲiɕɔ/
cynitej	/ˈt͡sɨnʲitej/
cynje	/ˈt͡sɨnʲɛ/
cysło	[ˈt͡sɨswɔ]
cysta	[ˈt͡sɨsta]
cyste	/ˈt͡sɨstɛ/
cysty	/ˈt͡sɨstɨ/
cyta	[ˈt͡sɨta]
cytanje	/ˈt͡sɨtanʲɛ/
cytaś	[ˈt͡sɨtaɕ]
cytat	[ˈt͡sɨtat]
čaj	/t͡ʃaj/
Česka	/ˈtʃɛska/
česki	[ˈtʃeskʲi]
da	/da/
dach	[dax]
daj	[daj]
dajo	[ˈdajɔ]
dajom	[ˈdajɔm]
daju	[ˈdaju]
dał	[ˈdaw]
dała	[ˈdawa]
dalej	/ˈdalɛj/
dali	/ˈdali/
dalina	/ˈdalina/
daloki	[ˈdalɔkʲi]
daloko	/ˈdalɔkɔ/
damast	/ˈdamast/
Dan	/dan/
Dana	/Ëˆdana/
dana	[Ëˆdana]
dane	/ˈdanɛ/
daneje	/ˈdanɛjɛ/
danem	[ˈdanɛm]
danje	/ˈdanʲɛ/
danju	[ˈdanʲu]
dank	/dank/
danki	/ˈdankʲi/
danku	/ˈdanku/
danu	/ˈdanu/
dany	[ˈdanɨ]
Dany	/ˈdanɨ/
daś	[daɕ]
dat	/dat/
daty	[ˈdatɨ]
dawa	[ˈdawa]
dawaj	[ˈdawaj]
dawaś	[ˈdawaɕ]
dawat	[ˈdawat]
dawno	/ˈdawnɔ/
dawny	/ˈdawnɨ/
dej	/dɛj/
dejał	/ˈdɛjaw/
dejanje	/ˈdɛjanʲɛ/
dejaś	/ˈdɛjaɕ/
deje	/ˈdɛjɛ/
deri	/ˈdɛrʲi/
deriś	/ˈdɛrʲiɕ/
dešć	/dɛɕt͡ɕ/
dirigent	/dʲirʲiˈɡʲɛnt/
dirigentka	/dʲirʲiˈɡʲɛntka/
diskutowaś	/dʲisˈkutɔwaɕ/
dłoń	[dwɔnʲ]
	
długa	[ˈdwuɡa]
długi	[ˈdwuɡʲi]
dłujki	/ˈdwujkʲi/
dłymoki	[ˈdwɨmɔkʲi]
dla	/dla/
dnja	[dnʲa]
do	/dɔ/
dobra	/ˈdɔbra/
dobre	/ˈdɔbrɛ/
dobrego	/ˈdɔbrɛɡɔ/
dobrej	/ˈdɔbrɛj/
dobrem	/ˈdɔbrɛm/
dobremu	/ˈdɔbrɛmu/
dobrota	/ˈdɔbrɔta/
dobru	/ˈdɔbru/
krowach	/Ëˆkrowax/
krowami	/ˈkrowamʲi/
krowy	/ˈkrowɨ/
Šwikawa	/ˈʃvʲikawa/
Mišnjo	/ˈmʲiʃnʲɔ/
Kamjenica	/ˈkamʲɛnʲit͡sa/
Frankobrod nad Odru	/ˈfrankɔbrɔt ˈnadɔdru/
ježe	/ˈjɛʒɛ/
Česka	/ˈtʃɛska/
Sakska	/ˈsakska/
bananu	/baˈnanu/
kobru	/ˈkɔbru/
kobry	/ˈkɔbrɨ/
kobrami	/ˈkɔbramʲi/
bruse	/ˈbrusɛ/
drapa	[ˈdrapa]
carna	[ˈt͡sarna]
duj	[duj]
ceje	/ˈt͡sɛjɛ/
segni	[ˈsɛɡnʲi]
dobry	/ˈdɔbrɨ/
dobrych	/ˈdɔbrɨx/
dobrym	/ˈdɔbrɨm/
dobrymi	/ˈdɔbrɨmʲi/
dokulaž	[ˈdɔkulaʃ]
doł	/dɔw/
dołojce	/ˈdɔwɔjt͡sɛ/
dole	/ˈdɔlɛ/
dolnoserbski	[ˈdɔlnɔˌsɛrskʲi]
dom	/dɔm/
doma	/ˈdɔma/
domk	[dɔmk]
domoju	[ˈdɔmɔju]
domy	/ˈdɔmɨ/
dosć	/dɔst͡ɕ/
drap	/drap/
drapa	[ˈdrapa]
drapaś	/ˈdrapaɕ/
drjewo	/ˈdrʲɛwɔ/
Drježdźany	/ˈdrʲɛʑdʑanɨ/
drob	/drɔp/
droba	/ˈdrɔba/
drobami	/ˈdrɔbamʲi/
droby	/ˈdrɔbɨ/
droga	/ˈdrɔɡa/
droge	/ˈdrɔɡʲɛ/
drogi	[ˈdrɔɡʲi]
drogich	/ˈdrɔɡʲix/
drogim	[ˈdrɔɡʲim]
drogimi	[ˈdrɔɡʲimʲi]
drogo	[ˈdrɔɡɔ]
drogowy	/ˈdrɔwɡɔwɨ/
droze	/ˈdrɔzɛ/
drozna	[ˈdrɔzna]
droznach	[ˈdrɔznax]
droznam	[ˈdrɔznam]
droznami	[ˈdrɔznamʲi]
droznje	/ˈdrɔznʲɛ/
droznoma	[ˈdrɔznɔma]
droznow	[ˈdrɔznow]
droznowu	[ˈdrɔznowu]
drozny	[ˈdrɔznɨ]
droždźeje	/ˈdrɔʑd͡ʑɛjɛ/
druga	[ˈdruɡa]
drugi	/ˈdruɡʲi/
drugich	/ˈdruɡʲix/
drugim	[ˈdruɡʲim]
drugimi	[ˈdruɡʲimʲi]
du	/du/
dub	/dup/
dubach	/Ëˆdubax/
dubje	/ˈdubʲɛ/
duj	[duj]
duł	[duw]
duli	[ˈdulʲi]
duś	/duɕ/
dut	/dut/
duta	[Ëˆduta]
dute	/ˈdutɛ/
dutu	[Ëˆdutu]
duty	[ˈdutɨ]
dwa	/dwa/
dwě	/dvʲɪ/
dwór	/dwɨr/
dycha	[ˈdɨxa]
dychaś	[ˈdɨxaɕ]
dym	/dɨm/
dyma	/ˈdɨma/
elektrikaŕ	[ɛˈlɛktrʲikarʲ]
Estniska	/ˈɛstnʲiska/
ezel	/ˈɛzɛl/
fabrice	/ˈfabrʲit͡sɛ/
fabrika	/ˈfabrʲika/
fabriki	/ˈfabrʲikʲi/
fagot	/faˈɡɔt/
fagota	[faˈɡɔta]
familija	/ˈfamʲilʲija/
fanfara	/fanˈfara/
fara	/ˈfara/
faram	/Ëˆfaram/
faraŕ	/ˈfararʲ/
faru	/Ëˆfaru/
fary	/ˈfarɨ/
fasada	/faˈsada/
ferije	/ˈfɛrʲijɛ/
fidle	/ˈfʲidlɛ/
formowaś	/ˈfɔrmɔwaɕ/
Francojska	/ˈfrant͡sɔjska/
Frankobrod nad Odru	/ˈfrankɔbrɔt ˈnadɔdru/
ga	[É¡a]
gaby	/ˈɡabɨ/
gad	/ɡat/
gada	/ˈɡada/
gadam	/ˈɡadam/
galerija	/ɡalɛˈrʲija/
gano	/ˈɡanɔ/
garba	/ˈɡarba/
gardina	/ɡarˈdʲina/
garona	/ˈɡarɔna/
gat	/ɡat/
gaž	[ɡaʃ]
gdy	/dɨ/
gdyby	/ˈdɨbɨ/
gib	/ɡʲip/
giba	[ˈɡʲiba]
gibanje	/ˈɡʲibanʲɛ/
gibaś	[ˈɡʲibaɕ]
gjarb	/ɡʲarp/
gjardło	/ˈɡʲardwɔ/
gjardy	/ˈɡʲardɨ/
gjarsć	/ɡʲarst͡ɕ/
gła	[ɡwa]
gładka	[ˈɡwatka]
gładki	[ˈɡwatkʲi]
gładkich	/ˈɡwatkʲix/
gładkim	[ˈɡwatkʲim]
gładkimi	[ˈɡwatkʲimi]
gładko	/ˈɡwatkɔ/
głos	[ɡwɔs]
głowa	[ˈɡwowa]
głowy	[ˈɡwowɨ]
głuchy	[ˈɡwuxɨ]
głupy	/ˈɡupɨ/
glej	/ɡlɛj/
glědaś	/ˈɡlʲɪdaɕ/
glicka	[ˈɡlʲitska]
gnězdo	/ˈɡnʲɪzdɔ/
gnida	/ˈɡnʲida/
gód	/ɡɨt/
gódy	/ˈɡɨdɨ/
gójś	/ɡɛjɕ/
gołub	[ˈɡowup]
gołubja	[ˈɡowubʲa]
goły	/ˈɡɔwɨ/
góla	/ˈɡɨla/
gólc	/ɡɨlt͡s/
góle	/ˈɡɨlɛ/
góleśa	/ˈɡɨlɛɕa/
góńtwowaś	/ˈɡɨnʲtwowaɕ/
góra	/ˈɡɨra/
górach	/ˈɡɨrax/
góram	/ˈɡɨram/
górami	/ˈɡɨramɨ/
górce	/ˈɡɨrt͡sɛ/
górjejce	/ˈɡɨrʲɛjt͡sɛ/
górka	/ˈɡɨrka/
górki	/ˈɡɨrkʲi/
góršy	/ˈɡɨrʃɨ/
góru	/ˈɡɨru/
góry	/ˈɡɨrɨ/
gósć	/ɡɨst͡ɕ/
gósća	/ˈɡɨst͡ɕa/
gósćeńc	/ˈɡɛst͡ɕɛnʲt͡s/
gósći	/ˈɡɨst͡ɕi/
gótowa	/ˈɡɨtɔwa/
gótowy	/ˈɡɨtɔwɨ/
gowjedo	/ˈɡɔvʲɛdɔ/
gózdź	/ɡɨst͡ɕ/
gózdźa	/ˈɡɨzd͡ʑa/
gózdźe	/ˈɡɨzd͡ʑɛ/
gózdźik	/ˈɡɨzdʑik/
góźina	/ˈɡɨʑina/
grab	[ɡrap]
graba	[ˈɡraba]
graj	[ɡraj]
grajo	[ˈɡrajɔ]
grał	[ɡraw]
grała	[ˈɡrawa]
grałej	[ˈɡrawej]
grało	[ˈɡrawɔ]
grali	/ˈɡrali/
granica	[ˈɡranʲit͡sa]
granice	/ˈɡranʲit͡sɛ/
granicowaś	[ˈɡranʲit͡sowaɕ]
graś	[ɡraɕ]
graśe	/ˈɡraɕɛ/
grat	/ɡrat/
grima	/ˈɡrʲima/
grimaś	[ˈɡrimaɕ]
griwa	[ˈɡrʲiwa]
grob	/ɡrɔp/
grobje	/ˈɡrɔbʲɛ/
grod	/ɡrɔt/
groda	[ˈɡrɔda]
grodowy	[ˈɡrɔdowɨ]
grody	/ˈɡrɔdɨ/
gromaźe	/ˈɡrɔmaʑɛ/
groni	/ˈɡrɔnʲi/
groniś	[ˈɡrɔnʲiɕ]
groza	/ˈɡrɔza/
groze	/ˈɡrɔzɛ/
grozu	/ˈɡrɔzu/
guba	/ˈɡuba/
gubawka	[ˈɡubawka]
gubu	[ˈɡubu]
gumno	[ˈɡumnɔ]
gumnyško	[ˈɡumnɨʃkɔ]
gus	/ɡus/
gusta	/ˈɡusta/
guste	/ˈɡustɛ/
krowach	/Ëˆkrowax/
krowami	/ˈkrowamʲi/
krowy	/ˈkrowɨ/
Šwikawa	/ˈʃvʲikawa/
Mišnjo	/ˈmʲiʃnʲɔ/
Kamjenica	/ˈkamʲɛnʲit͡sa/
Frankobrod nad Odru	/ˈfrankɔbrɔt ˈnadɔdru/
ježe	/ˈjɛʒɛ/
Česka	/ˈtʃɛska/
Sakska	/ˈsakska/
bananu	/baˈnanu/
kobru	/ˈkɔbru/
kobry	/ˈkɔbrɨ/
kobrami	/ˈkɔbramʲi/
bruse	/ˈbrusɛ/
drapa	[ˈdrapa]
carna	[ˈt͡sarna]
duj	[duj]
ceje	/ˈt͡sɛjɛ/
segni	[ˈsɛɡnʲi]
gustem	/ˈɡustɛm/
gusto	/ˈɡustɔ/
gustu	/ˈɡustu/
gusty	/ˈɡustɨ/
gwězda	/ˈɡvʲɪzda/
gymnazium	/ɡɨmˈnazium/
hengist	/ˈhɛŋʲɡʲist/
historiska	[hisˈtɔrʲiska]
historiske	/hisˈtɔrʲiskʲɛ/
historiski	[hisˈtɔrʲiskʲi]
how	/ɔw/
hurje	/ˈhurʲɛ/
huroma	/ˈhurɔma/
huru	/Ëˆhuru/
hynak	[ˈɨnak]
hyšći	[ˈɨɕtɕi]
hyś	/ɨɕ/
hyt	[ɨt]
informacija	/infɔrˈmat͡sija/
inženjer	/inʒɛˈnʲɛr/
inženjerka	/inʒɛˈnʲɛrka/
ja njerozmějom	/ja ˈnʲɛrɔzmʲɛjɔm/
jabłucyna	[ˈjabwutsɨna]
jabłuko	[ˈjabwukɔ]
jabłušcyna	[ˈjabwuʃtsɨna]
jacmjeń	/ˈjat͡smʲɛnʲ/
jaden	/ˈjadɛn/
jadno	[ˈjadnɔ]
jagnje	/ˈjaɡnʲɛ/
jagnjeśina	/ˈjaɡnʲɛɕina/
jagoda	/ˈjaɡɔda/
jaja	[Ëˆjaja]
jajach	/Ëˆjajax/
jajce	/ˈjajt͡sɛ/
jaji	[Ëˆjaji]
jajko	/ˈjajkɔ/
jajo	/ˈjajɔ/
jano	/ˈjanɔ/
jara	/Ëˆjara/
jare	/ˈjarɛ/
jarem	/ˈjarɛm/
jary	/ˈjarɨ/
jaskolicka	[ˈjaskɔlʲit͡ska]
jasne	/ˈjasnɛ/
jasniś	[ˈjasnʲiɕ]
jasno	/ˈjasnɔ/
jasny	/jasnɨ/
jasnych	/ˈjasnɨx/
jastśeb	/ˈjast͡ɕɛp/
jastśebik	/ˈjast͡ɕɛbʲik/
jastśebja	/ˈjast͡ɕɛbʲa/
jašćeŕ	/ˈjaɕt͡ɕɛrʲ/
jatšy	/ˈjat͡ʃɨ/
jazor	/ˈjazɔr/
jazoro	/ˈjazɔrɔ/
jazw	/jas/
je	/jɛ/
jeb	/jɛp/
jeba	/ˈjɛba/
jebany	/ˈjɛbanɨ/
jebat	/ˈjɛbat/
jedła	[ˈjɛdwa]
jedle	/ˈjɛdlɛ/
jegła	[ˈjɛɡwa]
jeglicka	/ˈjɛɡlit͡ska/
jej	[jej]
jeje	/ˈjɛjɛ/
jeju	[ˈjeju]
jelenica	/ˈjɛlɛnʲit͡sa/
jeleń	/ˈjɛlɛnʲ/
jen	[jɛn]
jerjeł	/ˈjɛrʲɛw/
jerła	/ˈjɛrwa/
jesotr	[ˈjɛsɔtr]
jež	/jeʃ/
ježe	/ˈjɛʒɛ/
ježyk	[ˈjɛʒɨk]
jědro	/ˈjɪdrɔ/
jědu	/ˈjɪdu/
jěł	/jɪw/
jěsć	/jɪst͡ɕ/
jěś	/jɪɕ/
jětša	/ˈjɪtʃa/
jěza	/ˈjɪza/
jězd	/jɪst/
jězdźiś	/ˈjɪzd͡ʑiɕ/
jězyk	/ˈjɪzɨk/
jěźech	/ˈjɪʑɛç/
jěźechmej	/ˈjɪʑɛçmɛj/
jěźechmy	/ˈjɪʑɛçmɨ/
jěźechu	/ˈjɪʑɛçu/
jěźecy	/ˈjɪʑɛt͡sɨ/
jěźenje	/ˈjɪʑɛnʲɛ/
jěźešćo	/ˈjɪʑɛɕt͡ɕɔ/
jěźešo	/ˈjɪʑɛʃɔ/
jěźeštej	/ˈjɪʑɛʃtej/
jěźo	/ˈjɪʑɔ/
jěźom	/ˈjɪʑɔm/
jěźony	/ˈjɪʑɔnɨ/
jich	/ˈjix/
jim	[jim]
jima	/ˈjima/
jo	[jɔ]
jogo	/ˈjɔɡɔ/
jogurt	/ˈjɔɡurt/
joli	/ˈjɔli/
jsu	[su]
ju	[ˈju]
jucha	[ˈjuxa]
južo	/ˈjuʒɔ/
k	/k/
kacka	/ˈkat͡ska/
kak	[kak]
kaka	/Ëˆkaka/
kakawa	/ˈkakawa/
kake	/ˈkakʲɛ/
kaki	[ˈkakʲi]
kaku	[Ëˆkaku]
kamel	/kaˈmɛl/
kamela	/kaˈmɛla/
kamele	/kaˈmɛlɛ/
Kamjenica	/ˈkamʲɛnʲit͡sa/
kamjeny	/ˈkamʲɛnɨ/
kamjeń	/ˈkamʲɛnʲ/
kana	[ˈkana]
kani	/ˈkanʲi/
kanja	/ˈkanʲa/
kanka	/ˈkanka/
kanki	/ˈkankʲi/
kanu	/Ëˆkanu/
	
kapa	/ˈkapa/
kapow	/ˈkapɔw/
kapu	/Ëˆkapu/
kara	/ˈkara/
karam	[Ëˆkaram]
karnikel	/karˈnʲikʲɛl/
karow	[ˈkarow]
	
karu	/Ëˆkaru/
karwona	[ˈkarwɔna]
kawce	/ˈkawt͡sɛ/
kawč	/kawt͡ʃ/
kawka	/ˈkawka/
kawkach	/Ëˆkawkax/
kawkami	/ˈkawkamʲi/
kawki	/ˈkawkʲi/
kaž	[kaʃ]
kenž	/kʲɛnʃ/
ketšup	/ˈkʲɛtʃup/
kida	[ˈkʲida]
kidaś	[ˈkʲidaɕ]
kidat	[ˈkʲidat]
kij	[kʲij]
kija	[ˈkʲija]
kijach	[ˈkʲijax]
kijami	[ˈkʲijamʲi]
kije	[ˈkʲijə]
kijom	[ˈkʲijɔm]
kiju	/ˈkʲiju/
kim	/ˈkʲim/
kisały	[ˈkʲisawɨ]
Kito	[ˈkʲitɔ]
kjałbasa	/ˈkʲawbasa/
kjarcma	/ˈkʲart͡sma/
kjarm	/kʲarm/
kjarmiś	[ˈkʲarmʲiɕ]
kłojś	[kwɔjɕ]
	
klěcaś	/ˈklɪt͡saɕ/
klěkaś	/ˈklʲɪkaɕ/
klěšće	/ˈklɪɕt͡ɕɛ/
klěś	/klɪɕ/
klin	[klʲin]
klina	[ˈklʲina]
klink	[klʲiŋk]
klon	[klɔn]
klona	[ˈklɔna]
klonam	[ˈklɔnam]
kmótš	/kmɨt͡ʃ/
kněni	/ˈknʲɪnʲi/
kněz	/knʲɪs/
kněžna	/ˈknʲɪʒna/
knigła	[ˈknʲiɡwa]
knigły	/ˈknʲiɡwɨ/
kobołk	/ˈkɔbowk/
kobra	/ˈkɔbra/
kobrami	/ˈkɔbramʲi/
kobru	/ˈkɔbru/
kobry	/ˈkɔbrɨ/
kobyła	/ˈkɔbɨwa/
kócka	/ˈkɨt͡ska/
kócor	/ˈkɨt͡sɔr/
kofer	/ˈkɔfɛr/
kofera	[ˈkɔfɛra]
kogo	/ˈkɔɡɔ/
kokoš	/ˈkɔkɔʃ/
kokoška	/ˈkɔkɔʃka/
kokot	/ˈkɔkɔt/
koł	[kow]
krowach	/Ëˆkrowax/
krowami	/ˈkrowamʲi/
krowy	/ˈkrowɨ/
Šwikawa	/ˈʃvʲikawa/
Mišnjo	/ˈmʲiʃnʲɔ/
Kamjenica	/ˈkamʲɛnʲit͡sa/
Frankobrod nad Odru	/ˈfrankɔbrɔt ˈnadɔdru/
ježe	/ˈjɛʒɛ/
Česka	/ˈtʃɛska/
Sakska	/ˈsakska/
bananu	/baˈnanu/
kobru	/ˈkɔbru/
kobry	/ˈkɔbrɨ/
kobrami	/ˈkɔbramʲi/
bruse	/ˈbrusɛ/
drapa	[ˈdrapa]
carna	[ˈt͡sarna]
duj	[duj]
ceje	/ˈt͡sɛjɛ/
segni	[ˈsɛɡnʲi]
koło	/ˈkowɔ/
kołp	/kɔwp/
kólaso	/ˈkɨlasɔ/
kole	[ˈkɔlɛ]
kóleno	/ˈkɨlɛnɔ/
komar	/ˈkɔmar/
komora	/ˈkɔmɛra/
komu	/ˈkɔmu/
kónja	/ˈkɨnʲa/
kónju	/ˈkɨnʲu/
kónopje	/ˈkɨnɔpʲɛ/
kóń	/kɨnʲ/
kóńc	/ˈkɨnʲt͡s/
kóńck	/kɨnʲtsk/
kóńcowaś	/ˈkɨnʲtsowaɕ/
kopš	[kɔpʃ]
kopyto	/ˈkɔpɨtɔ/
kórjeń	/ˈkɨrʲɛnʲ/
kóryto	/ˈkɨrɨtɔ/
kós	/kɨs/
kósa	/ˈkɨsa/
kósam	/ˈkɨsam/
kósć	/kɨst͡ɕ/
kóse	/ˈkɨsɛ/
kósu	/ˈkɨsu/
	
kót	/kɨt/
kóta	/ˈkɨta/
kótary	/ˈkɨtarɨ/
kótow	/ˈkɨtow/
kóza	/ˈkɛza/
kózoł	/ˈkɨzow/
kózyrožk	/ˈkɨzɨroʃk/
kóža	/ˈkɨʒa/
kraba	/ˈkraba/
kralik	/ˈkralik/
krogul	/ˈkrɔɡul/
krotki	[ˈkrɔtkʲi]
krotko	/ˈkrɔtkɔ/
krowa	/ˈkrowa/
krowach	/Ëˆkrowax/
krowami	/ˈkrowamʲi/
krowy	/ˈkrowɨ/
kšaj	[kʃaj]
kšajaś	[ˈkʃajaɕ]
kšasny	[ˈkʃasnɨ]
kšawny	[ˈkʃawnɨ]
kšej	/kʃɛj/
kšet	[kʃɛt]
kšupa	/ˈkʃupa/
kšupy	/ˈkʃupɨ/
kšuška	/ˈkʃuʃka/
kšuty	/ˈkʃutɨ/
kšyś	[kʃɨɕ]
kšyśe	/ˈkʃɨɕɛ/
kśebjat	/ˈkɕɛbʲat/
kśebjata	/ˈkɕɛbʲata/
kśemjeń	/ˈkɕɛmʲɛnʲ/
kśě	/kɕɪ/
kśěł	/kɕɪw/
kśěn	/kɕɪn/
kśěś	/kɕɪɕ/
kśidło	/ˈkɕidwɔ/
kśiwy	/ˈkɕiwɨ/
ku	/ku/
Kuba	/ˈkuba/
kuchni	[ˈkuxnʲi]
kuchnja	/ˈkuxnʲa/
kukawa	/ˈkukawa/
kulaty	[ˈkulatɨ]
kulka	/ˈkulka/
kulturny	[kulˈturnɨ]
kuna	[Ëˆkuna]
kunu	/Ëˆkunu/
kupadło	[ˈkupadwɔ]
kupka	[Ëˆkupka]
kupnica	[ˈkupnʲit͡sa]
kupnice	/ˈkupnʲit͡sɛ/
kura	/ˈkura/
kuram	/Ëˆkuram/
kurami	/ˈkuramʲi/
kurce	/ˈkurt͡sɛ/
kurjawa	[ˈkurʲawa]
kurka	/ˈkurka/
kurkach	[Ëˆkurkax]
kurkami	[ˈkurkamʲi]
kurki	/ˈkurkʲi/
kuru	/Ëˆkuru/
kurwota	/ˈkurwɔta/
kusa	/ˈkusa/
kusam	/ˈkusam/
kusaś	/ˈkusaɕ/
kuždy	/ˈkuʒdɨ/
kwas	[kwas]
kwět	/kvʲɪt/
kwětk	/kvʲɪtk/
łakomnik	[ˈwakɔmnʲik]
łdza	/d͡za/
łoj	[wɔj]
łojach	/ˈwɔjax/
łoje	/ˈwɔjɛ/
łojł	[wɔj]
łojm	[wɔjm]
łojś	/wɔjɕ/
łokś	[wɔkɕ]
łono	[ˈwɔnɔ]
łopata	/ˈwɔpata/
łopatka	/ˈwɔpatka/
łoska	[ˈwɔska]
łoski	/ˈwɔskʲi/
łoskich	/ˈwɔskʲix/
łoskim	[ˈwɔskʲim]
łoskimi	[ˈwɔskʲimi]
łosos	/ˈwɔsɔs/
łoź	[wɔɕ]
łyko	/ˈwɨkɔ/
lan	/lan/
lana	[Ëˆlana]
lanam	[ˈlanam]
lank	[ˈlaŋk]
lanka	/ˈlaŋka/
law	/law/
lawa	[Ëˆlawa]
lawk	/lawk/
laž	[laʃ]
lažał	[ˈlaʒaw]
lažaś	/ˈlaʒaɕ/
lažčejšy	/ˈlaʃt͡ʃɛjʃɨ/
laže	/ˈlaʒɛ/
lažki	[ˈlaʃkʲi]
lažy	[ˈlaʒɨ]
lažym	[ˈlaʒɨm]
leśe	/ˈlɛɕɛ/
leśeł	[ˈleɕɛw]
leśeś	[ˈleɕeɕ]
lěkaŕ	/ˈlɪkarʲ/
lěpšy	/ˈlɪpʃɨ/
lěs	/lɪs/
lěśe	/ˈlɪɕɛ/
lěto	/ˈlɪtɔ/
lěwy	/ˈlɪwɨ/
lězć	/ˈlɪst͡ɕ/
-li	/li/
-lic	/lit͡s/
lic	/lit͡s/
lice	/ˈlit͡sɛ/
licho	/ˈlixɔ/
lichy	/ˈlixɨ/
lico	/ˈlit͡sɔ/
licy	/ˈlit͡sɨ/
licyś	/ˈlit͡sɨɕ/
lip	/lip/
lipa	/ˈlipa/
lipaś	/ˈlipaɕ/
lipat	/ˈlipat/
lipoma	/ˈlipɔma/
Lipsk	/lipsk/
list	/list/
lista	/ˈlista/
listy	/ˈlistɨ/
liška	/ˈliʃka/
lod	/lɔt/
loda	[ˈlɔda]
lodka	[ˈlɔtka]
lody	[ˈlɔdɨ]
lube	/ˈlubɛ/
lubje	/ˈlubʲɛ/
lubjej	/ˈlubʲɛj/
lubowaś	/ˈlubɔwaɕ/
luby	[ˈlubɨ]
lud	/lut/
luda	[Ëˆluda]
ludam	[ˈludam]
luta	/Ëˆluta/
lute	/ˈlutɛ/
lutem	/ˈlutɛm/
lutu	/Ëˆlutu/
luty	/ˈlutɨ/
luź	/luɕ/
ma	[ma]
mack	/matÍ¡sk/
macka	/ˈmat͡ska/
mackach	/ˈmat͡skax/
mackami	/ˈmat͡skamʲi/
macki	/ˈmat͡skʲi/
mackom	/ˈmat͡skɔm/
maju	/ˈmaju/
mak	/mak/
maka	/Ëˆmaka/
makam	/Ëˆmakam/
maki	/ˈmakʲi/
maku	/Ëˆmaku/
mała	[ˈmawa]
małe	/ˈmawɛ/
mało	/ˈmawɔ/
mały	[ˈmawɨ]
małych	[ˈmawɨx]
malina	/ˈmalina/
malinami	/ˈmalinamʲi/
mam	[mam]
krowach	/Ëˆkrowax/
krowami	/ˈkrowamʲi/
krowy	/ˈkrowɨ/
Šwikawa	/ˈʃvʲikawa/
Mišnjo	/ˈmʲiʃnʲɔ/
Kamjenica	/ˈkamʲɛnʲit͡sa/
Frankobrod nad Odru	/ˈfrankɔbrɔt ˈnadɔdru/
ježe	/ˈjɛʒɛ/
Česka	/ˈtʃɛska/
Sakska	/ˈsakska/
bananu	/baˈnanu/
kobru	/ˈkɔbru/
kobry	/ˈkɔbrɨ/
kobrami	/ˈkɔbramʲi/
bruse	/ˈbrusɛ/
drapa	[ˈdrapa]
carna	[ˈt͡sarna]
duj	[duj]
ceje	/ˈt͡sɛjɛ/
segni	[ˈsɛɡnʲi]
mama	[Ëˆmama]
mamach	[Ëˆmamax]
mamam	/Ëˆmamam/
mamk a hamk	[ˌmamk a ˈhamk]
mamu	/Ëˆmamu/
mamy	/ˈmamɨ/
mapa	/ˈmapa/
mapje	/ˈmapʲɛ/
mapu	[Ëˆmapu]
mapy	[ˈmapɨ]
marchwej	/ˈmarxwɛj/
marchwje	/ˈmarxvʲɛ/
marjank	/ˈmarjaŋk/
marznjo	[ˈmarznʲɔ]
marznjom	[ˈmarznʲɔm]
marznu	[ˈmarznu]
marznuł	[ˈmarznuw]
marznuś	[ˈmarznuɕ]
masć	[mast͡ɕ]
masło	/ˈmaswɔ/
masle	/ˈmaslɛ/
maś	/maɕ/
mech	/mɛx/
mecha	/ˈmɛxa/
mej	/mɛj/
mě	/mʲɪ/
měch	/mʲɪx/
měki	/ˈmʲɪkʲi/
měra	/ˈmʲɪra/
měri	/ˈmʲɪrʲi/
měrił	/ˈmʲɪrʲiw/
měrim	/ˈmʲɪrʲim/
měriś	/ˈmʲɪrʲiɕ/
měrje	/ˈmʲɪrʲɛ/
měŕ	/mʲɪrʲ/
měsćanaŕ	/ˈmʲɪst͡ɕanarʲ/
měsćańske	/ˈmʲɪst͡ɕanʲskʲɛ/
měsćański	/ˈmʲɪst͡ɕanʲskʲi/
měso	/ˈmʲɪsɔ/
města	/ˈmʲɪsta/
městno	/ˈmʲɪstnɔ/
město	/ˈmʲɪstɔ/
měś	/mʲɪɕ/
Měto	/ˈmʲɪtɔ/
mězdze	/ˈmʲɪzd͡zɛ/
mězga	/ˈmʲɪzɡa/
měź	/mʲɪɕ/
miła	/ˈmʲiwa/
miłe	/ˈmʲiwɛ/
miłego	/ˈmʲiwɛɡɔ/
miłej	/ˈmʲiwej/
miłemu	/ˈmʲiwɛmu/
miły	/ˈmʲiwɨ/
miłych	/ˈmʲiwɨχ/
miłym	/ˈmʲiwɨm/
miłymi	/ˈmʲiwɨmʲi/
mimo	/ˈmʲimɔ/
Mišnjo	/ˈmʲiʃnʲɔ/
mjac	/mʲat͡s/
mjadwjeź	/ˈmʲadvʲeɕ/
mjasec	/ˈmʲasɛt͡s/
mjatel	/ˈmʲatɛl/
mjaza	[ˈmʲaza]
mjazy	/ˈmʲazɨ/
mjelcał	[ˈmʲɛlt͡saw]
mjelcaś	[ˈmʲeltsaɕ]
mjelce	[ˈmʲɛlt͡sɛ]
mjelcy	[ˈmʲɛlt͡sɨ]
mjelcym	[ˈmʲɛlt͡sɨm]
mjenja	[ˈmʲenʲa]
mjeńšy	[ˈmʲenʲʃɨ]
mjod	/mʲɔt/
mła	/mwa/
młode	/ˈmwɔdɛ/
młody	[ˈmwɔdɨ]
młoźinske	/ˈmɔʑinskʲɛ/
młoźinski	/ˈmɔʑinskʲi/
mlaś	/mlaɕ/
mloko	/ˈmlɔkɔ/
mnjo	[mnʲɔ]
móc	/mɨt͡s/
móct	/mɨt͡st/
moderna	[mɔˈdɛrna]
modernam	[mɔˈdɛrnam]
moderne	/mɔˈdɛrnɛ/
modernem	[mɔˈdɛrnɛm]
modernu	[mɔˈdɛrnu]
moderny	[mɔˈdɛrnɨ]
módle	/ˈmɨdlɛ/
módli	/ˈmɨdli/
módlił	/ˈmɨdliw/
módlim	/ˈmɨdlim/
módliś	/ˈmɨdliɕ/
módra	/ˈmɨdra/
módre	/ˈmɨdrɛ/
módru	/ˈmɨdru/
módry	/ˈmɨdrɨ/
mógł	/ˈmɨk/
mógła	/ˈmɨɡwa/
mógłej	/ˈmɨɡwɛj/
mógło	/ˈmɨɡwɔ/
mógli	/ˈmɨɡli/
mógu	/ˈmɨɡu/
mój	/mɛj/
mója	/ˈmɛja/
móje	/ˈmɛjɛ/
mójej	/ˈmɛjɛj/
mójo	/ˈmɛjɔ/
mokšy	[ˈmɔkʃɨ]
mól	/mɨl/
móla	/ˈmɨla/
mólach	/ˈmɨlax/
mólam	/ˈmɨlam/
móle	/ˈmɨlɛ/
móli	/ˈmɨli/
mólu	/ˈmɨlu/
móri	/ˈmɨrʲi/
mórjo	/ˈmɨrʲɔ/
mórzgi	/ˈmɨrzɡʲi/
móst	/mɨst/
móžo	/ˈmɨʒɔ/
móžom	/ˈmɨʒɔm/
móžomej	/ˈmɨʒɔmɛj/
móžomy	/ˈmɨʒɔmɨ/
móžoš	/ˈmɨʒɔʃ/
móžotej	/ˈmɨʒɔtɛj/
mrěś	/mrʲɪɕ/
mroja	[ˈmrɔja]
mrok	[mrɔk]
mroz	[mrɔs]
muce	/ˈmut͡sɛ/
mucha	/ˈmuxa/
muchy	[ˈmuxɨ]
mucka	[Ëˆmutska]
mudra	/Ëˆmudra/
mudry	[ˈmudrɨ]
muka	[ˈmuka]
muki	[ˈmukʲi]
muku	/ˈmuku/
mul	/mul/
mula	/ˈmula/
mulam	/ˈmulam/
mule	/ˈmulɛ/
muli	/ˈmuli/
mulu	/Ëˆmulu/
muski	[ˈmuskʲi]
muše	/ˈmuʃɛ/
mušla	[ˈmuʃla]
muž	/muʃ/
muže	/ˈmuʒɛ/
mydło	[ˈmɨdwɔ]
myjo	[ˈmɨjɔ]
myjom	[ˈmɨjɔm]
myju	[ˈmɨju]
mył	[mɨw]
myli	/ˈmɨli/
mysl	[mɨsl]
mysli	/ˈmɨsli/
mysliś	/ˈmɨsliɕ/
myslit	/ˈmɨslit/
myslony	/ˈmɨslɔnɨ/
myš	/mɨʃ/
myška	[ˈmɨʃka]
myś	/mɨɕ/
myśe	/ˈmɨɕɛ/
myt	/mɨt/
na	/na/
na pśikład	[ˈnapɕikwat]
na zasejwiźenje	/naˈzasɛjvʲiʑɛnʲɛ/
nadra	[Ëˆnadra]
nadro	[ˈnadrɔ]
naga	/ˈnaɡa/
nage	/ˈnaɡʲɛ/
nagi	/ˈnaɡʲi/
nagich	/ˈnaɡʲix/
nagim	/ˈnaɡʲim/
nagimi	/ˈnaɡʲimʲi/
nagu	/ˈnaɡu/
nakup	/ˈnakup/
nałpa	/ˈnawpa/
nalěwo	/ˈnalɪwɔ/
nam	[nam]
nama	[Ëˆnama]
nami	[ˈnamʲi]
nan	/nan/
nana	/Ëˆnana/
nanam	[Ëˆnanam]
nanom	[ˈnanɔm]
napad	[ˈnapat]
napis	[ˈnapʲis]
napšawo	/ˈnapʃawɔ/
nas	/nas/
nastwark	[ˈnastwark]
naš	[naʃ]
ned	/nÉ›t/
nejgóršy	/ˈnɛjɡɨrʃɨ/
ně	/nʲɪ/
něco	/ˈnʲɪt͡sɔ/
někotary	/ˈnʲɪkɔtarɨ/
něnt	/ˈnʲɪnt/
krowach	/Ëˆkrowax/
krowami	/ˈkrowamʲi/
krowy	/ˈkrowɨ/
Šwikawa	/ˈʃvʲikawa/
Mišnjo	/ˈmʲiʃnʲɔ/
Kamjenica	/ˈkamʲɛnʲit͡sa/
Frankobrod nad Odru	/ˈfrankɔbrɔt ˈnadɔdru/
ježe	/ˈjɛʒɛ/
Česka	/ˈtʃɛska/
Sakska	/ˈsakska/
bananu	/baˈnanu/
kobru	/ˈkɔbru/
kobry	/ˈkɔbrɨ/
kobrami	/ˈkɔbramʲi/
bruse	/ˈbrusɛ/
drapa	[ˈdrapa]
carna	[ˈt͡sarna]
duj	[duj]
ceje	/ˈt͡sɛjɛ/
segni	[ˈsɛɡnʲi]
něnto	/ˈnʲɪntɔ/
nich	/nʲix/
nim	/nʲim/
nima	/ˈnʲima/
Nimc	[nʲimt͡s]
Nimcowka	/ˈnʲimt͡sowka/
nime	/ˈnʲimɛ/
nimi	[nʲimʲi]
Nimska	/ˈnʲimska/
nimski	[ˈnʲimskʲi]
nimy	[ˈnʲimɨ]
niska	/ˈnʲiska/
niskich	/ˈnʲiskʲix/
niskim	[ˈnʲiskʲim]
niskimi	[ˈnʲiskʲimʲi]
nisko	/ˈnʲiskɔ/
niś	[nʲiɕ]
njabogi	[ˈnʲabɔɡʲi]
njasć	[nʲastɕ]
njasł	/ˈnʲas/
njaso	[ˈnʲasɔ]
njasom	[ˈnʲasɔm]
njasośo	[ˈnʲasɔɕɔ]
njasu	[ˈnʲasu]
-nje	/nʲɛ/
nje	[nʲɛ]
nje-	/nʲɛ/
njebjo	/ˈnʲɛbʲɔ/
njejdu	/ˈnʲɛjdu/
njejo	/ˈnʲɛjɔ/
njejsćo	/ˈnʲɛjst͡ɕɔ/
njejsmej	/ˈnʲɛjsmɛj/
njejsmy	/ˈnʲɛjsmɨ/
njejsom	/ˈnʲɛjsɔm/
njejstej	/ˈnʲɛjstɛj/
njejsu	/ˈnʲɛjsu/
njejsy	/ˈnʲɛjsɨ/
njejźo	/ˈnʲɛjʑɔ/
njejźom	/ˈnʲɛjʑɔm/
njejźomej	/ˈnʲɛjʑɔmɛj/
njejźoš	/ˈnʲɛjʑɔʃ/
njekśě	/ˈnʲɛkɕɪ/
njen	[nʲɛn]
njerěšny	/ˈnʲɛrʲɪʃnɨ/
njetopyŕ	/ˈnʲɛtɔpɨrʲ/
njewjedro	/ˈnʲɛvʲɛdrɔ/
njewjericka	/ˈnʲɛjɛrʲit͡ska/
njeźela	/ˈnʲɛʑɛla/
njom	[ˈnʲɔm]
nju	[ˈnʲu]
noc	/ˈnɔt͡s/
nocach	/ˈnɔt͡sax/
nocami	/ˈnɔt͡samʲi/
nocka	/ˈnɔt͡ska/
nocy	/ˈnɔt͡sɨ/
noga	/ˈnɔɡa/
nogami	[ˈnɔɡamʲi]
nogi	/ˈnɔɡʲi/
nokś	/nɔkɕ/
nos	/nɔs/
nosa	[ˈnɔsa]
nose	/ˈnɔsɛ/
nosu	[ˈnɔsu]
nowa	[Ëˆnowa]
nowe	/ˈnɔwɛ/
nowego	[ˈnowɛɡɔ]
nowo	/ˈnɔwɔ/
nowy	/ˈnowɨ/
noze	/ˈnɔzɛ/
nož	/nɔʃ/
nožyce	/ˈnɔʒɨt͡sɛ/
numer	/ˈnumɛr/
numera	[ˈnumɛra]
numeram	[ˈnumɛram]
nutśi	/ˈnut͡ɕi/
-owaś	/ɔwaɕ/
pada	[ˈpada]
padaj	[ˈpadaj]
padał	[ˈpadaw]
padała	[ˈpadawa]
padało	[ˈpadawɔ]
padali	/ˈpadali/
padam	[ˈpadam]
padamy	[ˈpadamɨ]
padaś	[ˈpadaɕ]
padat	[ˈpadat]
paduch	/ˈpadux/
pak	[pak]
pal	[pal]
pałco	[ˈpawt͡sɔ]
pałcom	[ˈpawt͡sɔm]
pałcu	[ˈpawt͡su]
pałka	[ˈpawka]
pałkach	[ˈpawkax]
pałkaju	[ˈpawkaju]
pałkał	[ˈpawkaw]
pałkam	[ˈpawkam]
pałkaś	[ˈpawkaɕ]
palach	/ˈpalax/
palack	[ˈpalatsk]
palc	/palt͡s/
pale	/ˈpalɛ/
pali	/ˈpali/
palica	/ˈpalit͡sa/
palice	/ˈpalit͡sɛ/
palił	/ˈpaliw/
paliła	/ˈpaliwa/
paliło	/ˈpaliwɔ/
palim	/ˈpalim/
palimy	/ˈpalimɨ/
pališ	/ˈpaliʃ/
paliś	/ˈpaliɕ/
paliśo	/ˈpaliɕɔ/
palit	/ˈpalit/
palona	/ˈpalɔna/
palone	/ˈpalɔnɛ/
palony	/ˈpalɔnɨ/
papa	/ˈpapa/
papam	[Ëˆpapam]
papje	/ˈpapʲɛ/
paprika	/ˈpaprʲika/
papriku	/ˈpapriku/
papu	[ˈpapu]
papy	[ˈpapɨ]
park	/park/
parka	/Ëˆparka/
parkam	[ˈparkam]
parki	[ˈparkʲi]
parku	[Ëˆparku]
pas	/pas/
pasa	[Ëˆpasa]
pasam	/ˈpasam/
pase	/ˈpasɛ/
pasu	[ˈpasu]
paśpula	/ˈpaɕpula/
pata	/ˈpata/
patu	/Ëˆpatu/
paw	/paw/
pawa	/ˈpawa/
pawk	/pawk/
pcha	/pxa/
pcołka	/ˈt͡sɔwka/
pěsć	/ˈpʲɪst͡ɕ/
pěsk	/pʲɪsk/
pěšy	/ˈpʲɪʃɨ/
pěś	/pʲɪɕ/
pěta	/ˈpʲɪta/
pětk	/pʲɪtk/
pětka	/ˈpʲɪtka/
pětkach	/ˈpʲɪtkax/
pětkam	/ˈpʲɪtkam/
pětkami	/ˈpʲɪtkamʲi/
pětki	/ˈpʲɪtkʲi/
pětkoma	/ˈpʲɪtkɔma/
pětkow	/ˈpʲɪtkɔw/
pětkowu	/ˈpʲɪtkɔwu/
pětku	/ˈpʲɪtku/
pij	[pʲij]
pijo	[ˈpʲijɔ]
pijom	[ˈpʲijɔm]
piju	[ˈpʲiju]
pił	[pʲiw]
piła	/ˈpʲiwa/
piłam	/ˈpʲiwam/
piło	/ˈpʲiwɔ/
piły	/ˈpʲiwɨ/
pile	/ˈpʲilɛ/
pili	/ˈpʲili/
pisa	[ˈpʲisa]
pisaju	[ˈpʲisaju]
pisał	/ˈpʲisaw/
pisam	[ˈpʲisam]
pisaś	/ˈpʲisaɕ/
pisaśo	[ˈpʲisaɕɔ]
piš	[pʲiʃ]
pišo	[ˈpʲiʃɔ]
pišom	[ˈpʲiʃɔm]
pišośo	[ˈpʲiʃɔɕɔ]
pišu	[ˈpʲiʃu]
piś	/pʲiɕ/
piśe	/ˈpʲiɕɛ/
pit	/pʲit/
pita	[ˈpʲita]
pite	/ˈpʲitɛ/
pitu	/ˈpʲitu/
pity	/ˈpʲitɨ/
piwo	/ˈpʲiwɔ/
pjac	/pʲat͡s/
pjaco	[ˈpʲat͡sɔ]
pjacom	[ˈpʲat͡sɔm]
pjakarja	[ˈpʲakarʲa]
pjakaŕ	[ˈpʲakarʲ]
pjakł	[ˈpʲak]
pjaku	[ˈpʲaku]
pjas	[pʲas]
pjelch	/pʲɛlx/
pjelniś	/ˈpʲɛlnʲiɕ/
pjenjeze	/ˈpʲɛnʲɛzɛ/
pjerina	/ˈpʲɛrʲina/
pjero	/ˈpʲɛrɔ/
krowach	/Ëˆkrowax/
krowami	/ˈkrowamʲi/
krowy	/ˈkrowɨ/
Šwikawa	/ˈʃvʲikawa/
Mišnjo	/ˈmʲiʃnʲɔ/
Kamjenica	/ˈkamʲɛnʲit͡sa/
Frankobrod nad Odru	/ˈfrankɔbrɔt ˈnadɔdru/
ježe	/ˈjɛʒɛ/
Česka	/ˈtʃɛska/
Sakska	/ˈsakska/
bananu	/baˈnanu/
kobru	/ˈkɔbru/
kobry	/ˈkɔbrɨ/
kobrami	/ˈkɔbramʲi/
bruse	/ˈbrusɛ/
drapa	[ˈdrapa]
carna	[ˈt͡sarna]
duj	[duj]
ceje	/ˈt͡sɛjɛ/
segni	[ˈsɛɡnʲi]
pławiś	/ˈpwavʲiɕ/
płod	[pwɔt]
płonina	[ˈpwɔnʲina]
płot	[pwɔt]
płotno	/ˈpwɔtnɔ/
płowy	/ˈpɔwɨ/
pług	/pwuk/
pługi	[ˈpwuɡʲi]
pla	/pla/
planowaś	[ˈplanowaɕ]
plasć	/plast͡ɕ/
plast	[plast]
plasta	/ˈplasta/
platł	[ˈplat]
pleśo	[ˈplɛɕɔ]
pleśom	[ˈplɛɕɔm]
pletu	[ˈplɛtu]
plěś	/plɪɕ/
pluwa	[ˈpluwa]
pluwaju	[ˈpluwaju]
pluwał	[ˈpluwaw]
pluwam	[ˈpluwam]
pluwaś	[ˈpluwaɕ]
pó	/pɨ/
pód	/pɨt/
pódla	/ˈpɨdla/
pódomk	/ˈpɨdɔmk/
połniś	[ˈpownʲiɕ]
połny	/ˈpownɨ/
połožyś	[ˈpowɔʒɨɕ]
póla	/ˈpɨla/
pólach	/pɨlax/
pólack	/ˈpɨlat͡sk/
Pólak	/ˈpɨlak/
póli	/ˈpɨli/
politika	/pɔˈlitʲika/
politiki	/pɔˈlitʲikʲi/
Pólka	/ˈpɨlka/
pólo	/ˈpɨlɔ/
pólska	/ˈpɨlska/
Pólska	/ˈpɨlska/
pólske	/ˈpɛlskʲɛ/
pólski	/ˈpɨlskʲi/
pólskich	/ˈpɛlskʲix/
pólskim	/ˈpɛlskʲim/
pólskimi	/ˈpɛlskʲimʲi/
pólsku	/ˈpɨlsku/
pólšćina	/ˈpɨlɕt͡ɕina/
pólu	/ˈpɨlu/
pomoc	/ˈpɔmɛt͡s/
pomocy	[ˈpɔmɛtsɨ]
pón	/pɨn/
pónjeźela	/ˈpɨnʲɛʑɛla/
pónjeźele	/ˈpɨnʲɛʑɛlɛ/
popjeł	/ˈpɔpʲɛw/
póra	/ˈpɨra/
póram	/ˈpɨram/
póraś	/ˈpɨraɕ/
pórat	/ˈpɨrat/
pósoł	/ˈpɨsɔw/
pótom	/ˈpɨtɔm/
powědański	/ˈpovʲɪdanʲskʲi/
powědaś	/ˈpovʲɪdaɕ/
pówětš	/ˈpɨvʲɪt͡ʃ/
powěźeś	/ˈpovʲɪʑeɕ/
powrjoz	/ˈpowrʲɔs/
prama	/ˈprama/
pramu	/Ëˆpramu/
pranje	/ˈpranʲɛ/
praś	[praɕ]
prat	[prat]
prěcny	/ˈprʲɪt͡snɨ/
prědk	/prʲɪtk/
prědny	/ˈprʲɪdnɨ/
prězy	/ˈprʲɪzɨ/
proch	/prɔx/
prog	[prɔk]
proga	/ˈprɔɡa/
progi	/ˈprɔɡʲi/
prose	/ˈprɔsɛ/
proseśa	[ˈprɔsɛɕa]
proseśi	[ˈprɔsɛɕi]
proseta	[ˈprɔsɛta]
prozniny	/ˈprɔznʲinɨ/
prozny	/ˈprɔznɨ/
psa	/psa/
psu	[psu]
psy	/psÉ¨/
pšawem	[ˈpʃawɛm]
pšawo	[ˈpʃawɔ]
pšawy	[ˈpʃawɨ]
pšenica	[ˈpʃɛnʲit͡sa]
pšenice	/ˈpʃɛnʲit͡sɛ/
pšose	/ˈpʃɔsɛ/
pšoso	[ˈpʃɔsɔ]
pšosty	[ˈpʃɔstɨ]
pšosy	[ˈpʃɔsɨ]
pšosył	[ˈpʃɔsɨw]
pšosym	[ˈpʃɔsɨm]
pšosyś	/ˈpʃɔsɨɕ/
pšut	/pʃut/
pśechójźowaś	/ˈpɕɛxɛjʑɔwaɕ/
pśechwatanje	/ˈpɕɛxwatanʲɛ/
pśed	/pɕɛt/
pśedajo	[ˈpɕɛdajɔ]
pśedajom	[ˈpɕɛdajɔm]
pśedaju	[ˈpɕɛdaju]
pśedał	[ˈpɕɛdaw]
pśedaś	[ˈpɕɛdaɕ]
pśedawarnja	[ˈpɕɛdawarnʲa]
pśedešćnik	/ˈpɕɛdɛɕt͡ɕnʲik/
pśez	/pɕɛs/
pśědł	/ˈpɕɪt/
pśědu	/ˈpɕɪdu/
pśěsć	/pɕɪst͡ɕ/
pśěźo	/ˈpɕɪʑɔ/
pśěźom	/ˈpɕɪʑɔm/
pśi	/pɕi/
pśichod	/ˈpɕixɔt/
pśichodny nan	/ˈpɕixɔdnɨ ˈnan/
pśigótowaś	/ˈpɕiɡɨtowaɕ/
pśigótujo	/ˈpɕiɡɨtujɔ/
pśijaśel	/ˈpɕijaɕel/
pśikład	[ˈpɕikwat]
pśiś	[pɕiɕ]
ptašk	/ptaʃk/
ptaškowa swajźba	/ˈptaʃkɔwa ˈswajʑba/
ptaškowy	/ˈptaʃkɔwɨ/
pusta	/Ëˆpusta/
puste	/ˈpustɛ/
pusty	/ˈpustɨ/
pušćaś	[ˈpuɕt͡ɕaɕ]
puta	/ˈputa/
putam	/ˈputam/
putu	/Ëˆputu/
pyrje	/ˈpɨrʲɛ/
pyta	[ˈpɨta]
pytaj	[ˈpɨtaj]
pytaju	[ˈpɨtaju]
pytał	[ˈpɨtaw]
pytała	[ˈpɨtawa]
pytało	[ˈpɨtawɔ]
pytali	/ˈpɨtali/
pytam	[ˈpɨtam]
pytamy	[ˈpɨtamɨ]
pytanje	/ˈpɨtanʲɛ/
pytaś	[ˈpɨtaɕ]
pyto	/ˈpɨtɔ/
rad	/rat/
rada	/Ëˆrada/
radijo	/ˈradʲijɔ/
radło	/ˈradwɔ/
rado	/ˈradɔ/
rady	/ˈradɨ/
rak	/rak/
raka	/Ëˆraka/
rakach	/Ëˆrakax/
rakam	/Ëˆrakam/
raki	/ˈrakʲi/
raku	/Ëˆraku/
ramje	/ˈramʲɛ/
rdžaś	/rd͡ʒaɕ/
rež	[rɛʃ]
rěc	/rʲɪt͡s/
rěd	/rʲɪt/
rědki	/ˈrʲɪtkʲi/
rědne	/ˈrʲɪdnɛ/
rědny	/ˈrʲɪdnɨ/
rěka	/ˈrʲɪka/
rězaś	/ˈrʲɪzaɕ/
ric	[ˈrʲit͡s]
ricał	[ˈrʲit͡saw]
ricali	/ˈrʲit͡sali/
ricaś	[ˈrʲit͡saɕ]
rice	/ˈrʲit͡sɛ/
ricy	[ˈrʲit͡sɨ]
ricym	[ˈrʲit͡sɨm]
rjemjeń	/ˈrʲɛmʲɛnʲ/
rjeśaz	/ˈrʲɛɕas/
rjobło	/ˈrʲɔbwɔ/
rjobro	/ˈrʲɔbrɔ/
rod	/rɔt/
roda	/ˈrɔda/
rodach	/ˈrɔdax/
rodam	/ˈrɔdam/
rodami	/ˈrɔdamʲi/
rodom	/ˈrɔdɔm/
rody	/ˈrɔdɨ/
rog	[rɔk]
roga	/ˈrɔɡa/
rogam	/ˈrɔɡam/
rogi	[ˈrɔɡʲi]
roj	/rɔj/
roja	/ˈrɔja/
roju	/ˈrɔja/
ros	/rɔs/
rosa	/ˈrɔsa/
rosach	[ˈrɔsax]
rosam	[ˈrɔsam]
rosć	/rɔst͡ɕ/
krowach	/Ëˆkrowax/
krowami	/ˈkrowamʲi/
krowy	/ˈkrowɨ/
Šwikawa	/ˈʃvʲikawa/
Mišnjo	/ˈmʲiʃnʲɔ/
Kamjenica	/ˈkamʲɛnʲit͡sa/
Frankobrod nad Odru	/ˈfrankɔbrɔt ˈnadɔdru/
ježe	/ˈjɛʒɛ/
Česka	/ˈtʃɛska/
Sakska	/ˈsakska/
bananu	/baˈnanu/
kobru	/ˈkɔbru/
kobry	/ˈkɔbrɨ/
kobrami	/ˈkɔbramʲi/
bruse	/ˈbrusɛ/
drapa	[ˈdrapa]
carna	[ˈt͡sarna]
duj	[duj]
ceje	/ˈt͡sɛjɛ/
segni	[ˈsɛɡnʲi]
rose	/ˈrɔsɛ/
roska	[ˈrɔska]
roskam	[ˈrɔskam]
rost	[rɔst]
rostu	[ˈrɔstu]
rosy	[ˈrɔsɨ]
row	/rɔw/
rowny	/ˈrɔwnɨ/
rozgranjaś se	/ˈrɔzɡranʲaɕ/
rožk	[rɔʃk]
rub	[rup]
ruba	[ˈruba]
rubaj	[ˈrubaj]
rubaju	[ˈrubaju]
rubał	[ˈrubaw]
rubam	[ˈrubam]
rubaś	[ˈrubaɕ]
rubjo	[ˈrubʲɔ]
rubjom	[ˈrubʲɔm]
rubju	[ˈrubʲu]
ruce	/ˈrut͡sɛ/
ruda	/ˈruda/
rudam	/ˈrudam/
rudawy	/ˈrudawɨ/
rudu	/Ëˆrudu/
rudy	/ˈrudɨ/
ruka	/ˈruka/
rukajca	[ˈrukajt͡sa]
ruki	[ˈrukʲi]
ruku	[Ëˆruku]
rum	[rum]
ruma	/Ëˆruma/
rumam	[Ëˆrumam]
rumnosć	[ˈrumnɔstɕ]
ryba	/ˈrɨba/
rybarnik	/ˈrɨbarnʲik/
rybce	/ˈrɨpt͡sɛ/
rybka	[ˈrɨpka]
rybkach	[Ëˆripkax]
rybkami	[ˈrɨpkamʲi]
rybki	[ˈrɨpkʲi]
rybnica	/ˈrɨbnʲit͡sa/
ryby	[ˈrɨbɨ]
ryj	[rɨj]
rys	/rɨs/
ryś	[rɨɕ]
ryt	/rɨt/
ryzy	/ˈrɨzɨ/
rza	/rza/
ŕ	/rʲ/
sad	[sat]
sada	/Ëˆsada/
sadło	[ˈsadwɔ]
sadom	[ˈsadɔm]
sajźiś	[ˈsajʑiɕ]
Sakska	/ˈsakska/
sarna	/ˈsarna/
saźe	/ˈsaʑɛ/
sćěna	/ˈst͡ɕɪna/
sćěnje	/ˈst͡ɕɪnʲɛ/
sćo	/st͡ɕɔ/
se	[sɛ]
se wě	/sɛ ˈvʲɪ/
sec	/sɛt͡s/
seco	[ˈsɛt͡sɔ]
sect	[sɛt͡st]
sedło	/ˈsɛdwɔ/
sednuś	[ˈsɛdnuɕ]
sedym	/ˈsɛdɨm/
segni	[ˈsɛɡnʲi]
segnuś	[ˈsɛɡnuɕ]
sej	/sɛj/
sejźe	/ˈsɛjʑɛ/
sejźeł	/ˈsɛjʑɛw/
sejźeś	/ˈsɛjʑɛɕ/
sejźi	/ˈsɛjʑi/
sejźim	/ˈsɛjʑim/
seku	[ˈsɛku]
semje	/ˈsɛmʲɛ/
sena	/ˈsɛna/
senam	[ˈsɛnam]
seno	/ˈsɛnɔ/
senu	[ˈsɛnu]
sera	/ˈsɛra/
seram	[ˈsɛram]
Serb	[sɛrp]
serbiska	[ˈsɛrbʲiska]
serbiske	/ˈsɛrbʲiskʲɛ/
serbiski	[ˈsɛrbʲiskʲi]
serbisku	[ˈsɛrbʲisku]
Serbowka	[ˈsɛrbowka]
serbska	[ˈsɛrska]
serbski	[ˈsɛrskʲi]
serbskich	/ˈsɛrskʲix/
serbskim	[ˈsɛrskʲim]
serbskimi	[ˈsɛrskʲimʲi]
serbšćina	[ˈsɛrɕtɕina]
serca	[ˈsɛrt͡sa]
sercach	[ˈsɛrt͡sax]
serce	/ˈsɛrt͡sɛ/
seroma	[ˈsɛrɔma]
serow	[ˈsɛrow]
serp	/sɛrp/
serpa	/ˈsɛrpa/
serpam	/ˈsɛrpam/
sery	[ˈsɛrɨ]
seś	[sɛɕ]
set	[sɛt]
skócyś	/ˈskɨt͡sɨɕ/
skok	[skɔk]
skóńcowaś	/ˈskɨnʲt͡sɔwaɕ/
skóro	/ˈskɨrɔ/
skót	/skɨt/
słaby	[ˈswabɨ]
sława	[ˈswawa]
słodka	[ˈswɔtka]
słodki	/ˈswɔtkʲi/
słodkich	/ˈswɔtkʲix/
słodkim	[ˈswɔtkʲim]
słodkimi	[ˈswɔtkʲimʲi]
słoma	/ˈswɔma/
słomce	/ˈswɔmt͡sɛ/
słomka	/ˈswɔmka/
słomkach	/ˈswɔmkax/
słomkami	[ˈswɔmkamʲi]
słomki	[ˈswɔmkʲi]
słon	[swɔn]
słona	[ˈswɔna]
słony	[ˈswɔnɨ]
słowa	[ˈswowa]
słowo	/ˈswowɔ/
słup	[swup]
słyńco	/ˈswɨnʲt͡sɔ/
słyšaś	/ˈswɨʃaɕ/
slach	[slax]
slam	[slam]
slami	[ˈslamʲi]
slě	/slʲɪ/
slěpy	/ˈslɪpɨ/
slěwka	/ˈslɪwka/
slězy	/ˈslɪzɨ/
slinik	[ˈslʲinʲik]
slow	[slow]
smej	/smɛj/
smjerś	/smʲɛrɕ/
smy	/smɨ/
snědanje	/ˈsnʲɪdanʲɛ/
snědaś	/ˈsnʲɪdaɕ/
sněg	/snʲɪk/
sobota	/ˈsɔbɛta/
socha	/ˈsɔxa/
sodło	/ˈsɔdwɔ/
sol	/sɔl/
solam	[ˈsɔlam]
soli	/ˈsɔli/
solny	[ˈsɔlnɨ]
solu	[ˈsɔlu]
som	/sɔm/
son	[sɔn]
sona	/ˈsɔna/
sonach	[ˈsɔnax]
sonje	/ˈsɔnʲɛ/
sony	[ˈsɔnɨ]
sotša	/ˈsɔt͡ʃa/
sotše	/ˈsɔt͡ʃɛ/
sotšu	/ˈsɔt͡ʃu/
sowa	[ˈsowa]
spach	[spax]
spachmej	[ˈspaxmej]
spachmy	[ˈspaxmɨ]
spachu	[ˈspaxu]
spał	[ˈspaw]
spała	[ˈspawa]
spałej	/ˈspawɛj/
spało	[ˈspawɔ]
spali	/ˈspali/
spana	[Ëˆspana]
spane	/ˈspanɛ/
spany	[ˈspanɨ]
spańska śpa	[ˈspanʲska ˈɕpa]
spański	/ˈspanʲskʲi/
spašćo	[ˈspaɕtɕɔ]
spašo	[ˈspaʃɔ]
spaštej	/ˈspaʃtɛj/
spaś	/ˈspaɕ/
spat	[spat]
spě	/spʲɪ/
spi	[spʲi]
spica	[ˈspʲit͡sa]
spice	/ˈspʲit͡sɛ/
spicy	/ˈspʲit͡sɨ/
spiju	[ˈspʲiju]
spijucy	[ˈspʲijutsɨ]
spim	[spʲim]
spimej	[ˈspʲimej]
spimy	[ˈspʲimɨ]
spiš	[spʲiʃ]
spiśo	[ˈspʲiɕɔ]
spitej	/ˈspʲitɛj/
spiwa	[ˈspʲiwa]
krowach	/Ëˆkrowax/
krowami	/ˈkrowamʲi/
krowy	/ˈkrowɨ/
Šwikawa	/ˈʃvʲikawa/
Mišnjo	/ˈmʲiʃnʲɔ/
Kamjenica	/ˈkamʲɛnʲit͡sa/
Frankobrod nad Odru	/ˈfrankɔbrɔt ˈnadɔdru/
ježe	/ˈjɛʒɛ/
Česka	/ˈtʃɛska/
Sakska	/ˈsakska/
bananu	/baˈnanu/
kobru	/ˈkɔbru/
kobry	/ˈkɔbrɨ/
kobrami	/ˈkɔbramʲi/
bruse	/ˈbrusɛ/
drapa	[ˈdrapa]
carna	[ˈt͡sarna]
duj	[duj]
ceje	/ˈt͡sɛjɛ/
segni	[ˈsɛɡnʲi]
spiwaju	[ˈspʲiwaju]
spiwał	[ˈspʲiwaw]
spiwam	[ˈspʲiwam]
spiwaś	[ˈspʲiwaɕ]
spižka	[ˈspʲiʃka]
spódobaś	/ˈspɨdɔbaɕ/
spóra	/ˈspɨra/
spóraś	/ˈspɨraɕ/
sport	/spɔrt/
sporta	[ˈspɔrta]
sportam	[ˈspɔrtam]
sporty	/ˈspɔrtɨ/
Sprjewja	/ˈsprʲɛvʲa/
srjejź	/srʲɛjɕ/
srjoda	[ˈsrʲɔda]
stadło	/ˈstadwɔ/
stadle	/ˈstadlɛ/
staja	[ˈstaja]
stajaś	[ˈstajaɕ]
stajiś	[ˈstajiɕ]
stara	[Ëˆstara]
stare	/ˈstarɛ/
starego	[ˈstarɛɡɔ]
starej	/ˈstarɛj/
stareje	/ˈstarɛjɛ/
stareju	/ˈstarɛju/
starem	[ˈstarɛm]
staremu	[ˈstarɛmu]
starjejše	/ˈstarʲɛjʃɛ/
starjejšej	/ˈstarʲɛjʃɛj/
staru	[Ëˆstaru]
stary	/ˈstarɨ/
starych	[ˈstarɨx]
starym	[ˈstarɨm]
staryma	[ˈstarɨma]
starymi	[ˈstarɨmʲi]
statny	[ˈstatnɨ]
stawizny	[ˈstavʲiznɨ]
stej	/stɛj/
stil	/stʲil/
stilist	/stʲiˈlist/
stilistika	/stʲiˈlistʲika/
stog	/stɔk/
stoga	/ˈstɔɡa/
stoj	[stɔj]
stojał	/ˈstɔjaw/
stojaś	/ˈstɔjaɕ/
stojm	/stɔjm/
stoł	/stɔw/
stole	/ˈstɔlɛ/
strow	/strow/
strowiś	[ˈstrowiɕ]
strowy	[ˈstrowɨ]
stśěła	/ˈst͡ɕɪwa/
studěrowaś	/stuˈdʲɪrɔwaɕ/
studowaś	/ˈstudɔwaɕ/
stup	[stup]
stupi	[ˈstupʲi]
stupiś	[ˈstupʲiɕ]
stwórtk	/stwɨrtk/
styri	/ˈstɨrʲi/
styrjo	[ˈstɨrʲɔ]
su	[su]
suche	/ˈsuxɛ/
sucho	/ˈsuxɔ/
suchy	/ˈsuxɨ/
sudnica	[ˈsudnʲit͡sa]
sudnik	[ˈsudnʲik]
sup	/sup/
supa	/Ëˆsupa/
swack	[swatsk]
swajźba	[ˈswajʑba]
swak	[swak]
swět	/svʲɪt/
swětki	/ˈsvʲɪtkʲi/
swětły	/ˈsvʲɪtwɨ/
swěty	/ˈsvʲɪtɨ/
swinja	/ˈsvʲinʲa/
swój	/swɛj/
swója	/ˈswɛja/
swóje	/ˈswɛjɛ/
swójej	/ˈswɛjɛj/
swójźba	/ˈswɛjʑba/
sy	[sɨ]
sykora	/ˈsɨkɔra/
sykorka	[ˈsɨkɔrka]
syłoj	/ˈsɨwɔj/
syłojik	/ˈsɨwɔjik/
syłojk	/ˈsɨwɔjk/
sylny	/ˈsɨlnɨ/
syn	/sɨn/
syna	/ˈsɨna/
synk	[sɨŋk]
synoju	[ˈsɨnɔju]
syra	/ˈsɨra/
syre	/ˈsɨrɛ/
syrotny	/ˈsɨrɔtnɨ/
syry	/ˈsɨrɨ/
syte	/ˈsɨtɛ/
syto	/ˈsɨtɔ/
syty	[ˈsɨtɨ]
šćenje	/ˈɕt͡ɕɛnʲɛ/
šery	/ˈʃɛrɨ/
škobrjonk	/ˈʃkɔbrʲɔŋk/
škóra	/ˈʃkɨra/
škórc	/ʃkɨrt͡s/
škrja	/ʃkrʲa/
škrjok	/ʃkrʲɔk/
škrjono	[ˈʃkrʲɔnɔ]
šołta	/ˈʃowta/
štap	[ʃtap]
štapaś	[ˈʃtapaɕ]
štunda	/ˈʃtunda/
šula	/ˈʃula/
šulaŕ	[ˈʃularʲ]
šule	/ˈʃulɛ/
šurowaś	[ˈʃurowaɕ]
Šwicaŕska	/ˈɕvʲit͡sarʲska/
šwigersyn	[ˈʃvʲiɡʲɛrˌsɨn]
šwigerźowka	[ˈʃvʲiɡʲɛrˌʑowka]
Šwikawa	/ˈʃvʲikawa/
šwon	[ʃwɔn]
šyja	[ˈʃɨja]
šyroki	[ˈʃɨrɔkʲi]
šyś	/ʃɨɕ/
Ś	/ɕ/
śamny	/ˈɕamnɨ/
śańki	/ˈɕankʲi/
-śe	/ɕɛ/
śele	/ˈɕɛlɛ/
śepaś	[ˈɕɛpaɕ]
śeśko	[ˈɕɛɕkɔ]
śěgaś	/ˈɕɪɡaɕ/
śěgnuś	/ˈɕɪɡnuɕ/
śěło	/ˈɕɪwɔ/
śěsny	/ˈɕɪsnɨ/
śěsto	/ˈɕɪstɔ/
śěžki	/ˈɕɪʃkʲi/
śichy	/ˈɕixɨ/
śopły	/ˈɕɔpwɨ/
śpa	/ɕpa/
ta	[ta]
tabela	/taˈbɛla/
tak	/tak/
taktika	/ˈtaktʲika/
taktiki	/ˈtaktʲikʲi/
tam	[tam]
tapeta	/taˈpɛta/
tasa	/ˈtasa/
tase	/ˈtasɛ/
taska	/Ëˆtaska/
taski	/ˈtaskʲi/
tasku	/ˈtasku/
tasow	/ˈtasɔw/
tasu	[ˈtasu]
te	[tÉ›]
tej	/tɛj/
teja	/ˈtɛja/
teje	/ˈtɛjɛ/
teju	/ˈtɛju/
teke	/ˈtɛkʲɛ/
telewizor	/tɛlɛˈvʲizɔr/
ten	[tÉ›n]
tenraz	/ˈtɛnras/
terasa	/tɛˈrasa/
terase	/tɛˈrasɛ/
terasu	[tɛˈrasu]
tkaj	[tkaj]
tkała	[ˈtkawa]
tkałej	/ˈtkawɛj/
tkało	[ˈtkawɔ]
tkali	/ˈtkali/
tkaś	[tkaɕ]
tłocy	/ˈtwɔt͡sɨ/
tłocył	/ˈtwɔt͡sɨw/
tłocym	/ˈtwɔt͡sɨm/
tłocyś	/ˈtwɔt͡sɨɕ/
tłusty	[ˈtwustɨ]
to	[tÉ”]
toaleta	/toaˈlɛta/
toboła	[ˈtɔbowa]
tobu	[ˈtɔbu]
togo	[ˈtɔɡɔ]
togodla	/ˈtɔɡɔdla/
tom	[tÉ”m]
tomu	[ˈtɔmu]
toporišćo	/ˈtɔpɔrʲiɕt͡ɕɔ/
torm	/tɔrm/
torma	[ˈtɔrma]
trěś	/tʲrʲɪɕ/
tšach	[t͡ʃax]
tšawa	/ˈt͡ʃawa/
tšochu	[ˈt͡ʃɔxu]
tśěsć	/t͡ɕɪst͡ɕ/
tśi	/tɕi/
tśmjel	/tɕmʲɛl/
tśmjeń	/t͡ɕmʲɛnʲ/
tśo	/t͡ɕɔ/
tu	/tu/
tucne	/ˈtut͡snɛ/
krowach	/Ëˆkrowax/
krowami	/ˈkrowamʲi/
krowy	/ˈkrowɨ/
Šwikawa	/ˈʃvʲikawa/
Mišnjo	/ˈmʲiʃnʲɔ/
Kamjenica	/ˈkamʲɛnʲit͡sa/
Frankobrod nad Odru	/ˈfrankɔbrɔt ˈnadɔdru/
ježe	/ˈjɛʒɛ/
Česka	/ˈtʃɛska/
Sakska	/ˈsakska/
bananu	/baˈnanu/
kobru	/ˈkɔbru/
kobry	/ˈkɔbrɨ/
kobrami	/ˈkɔbramʲi/
bruse	/ˈbrusɛ/
drapa	[ˈdrapa]
carna	[ˈt͡sarna]
duj	[duj]
ceje	/ˈt͡sɛjɛ/
segni	[ˈsɛɡnʲi]
tuni	/ˈtunʲi/
tupy	[ˈtupɨ]
tur	/tur/
tura	[Ëˆtura]
turam	[ˈturam]
turami	[ˈturamʲi]
twarda	/Ëˆtwarda/
twardy	/ˈtwardɨ/
twarjenja	/ˈtwarʲɛnʲa/
twarjenje	/ˈtwarʲɛnʲɛ/
twój	/twɛj/
twója	/ˈtwɛja/
twóje	/ˈtwɛjɛ/
twójej	/ˈtwɛjɛj/
twóŕ	/twɨrʲ/
ty	[tɨ]
tych	[tÉ¨x]
tym	[tÉ¨m]
tyma	[ˈtɨma]
tymi	[ˈtɨmʲi]
tyźeń	/ˈtɨʑɛnʲ/
w	/w/
wałma	/ˈwawma/
wałtora	/ˈwawtɔra/
wam	[wam]
wama	/Ëˆwama/
wami	[ˈwamʲi]
wari	[ˈwarʲi]
wariś	/ˈwarʲiɕ/
Waršawa	[ˈwarʃawa]
was	[was]
waš	[waʃ]
we	/wÉ›/
wej	/wɛj/
wence	/ˈwɛnt͡sɛ/
weš	[wɛʃ]
wě	/vʲɪ/
wěc	/vʲɪt͡s/
wědomnosć	/ˈvʲɪdɔmnɔst͡ɕ/
wěnc	/vʲɪnt͡s/
wětš	/vʲɪt͡ʃ/
wětšy	/ˈvʲɪt͡ʃɨ/
wězaś	/ˈvʲɪzaɕ/
wěźeś	/ˈvʲɪʑɛɕ/
widlicki	/ˈvʲidlit͡skʲi/
wiki	/ˈvʲikʲi/
wina	/ˈvʲina/
wino	/ˈvʲinɔ/
wišnja	[ˈvʲiʃnʲa]
wita	/ˈvʲita/
witaj	[ˈvʲitaj]
witał	[ˈvʲitaw]
witała	[ˈvʲitawa]
witało	[ˈvʲitawɔ]
witali	/ˈvʲitali/
witam	[ˈvʲitam]
witamy	[ˈvʲitamɨ]
witaś	/ˈvʲitaɕ/
witśe	/ˈvʲit͡ɕɛ/
wiźenje	/ˈvʲiʑɛnʲɛ/
wiźeś	/ˈvʲiʑɛɕ/
wjacerja	[ˈvʲat͡sɛrʲa]
wjacerjaś	[ˈvʲat͡sɛrʲaɕ]
wjacor	/ˈvʲat͡sɔr/
wjapś	[vʲapɕ]
wjas	[vʲas]
wjasć	/vʲast͡ɕ/
wjasele	/ˈvʲasɛlɛ/
wjasoły	/ˈjasɔwɨ/
wjaža	[ˈvʲaʒa]
wjele	/ˈvʲɛlɛ/
wjelgin	/ˈvʲɛlɡʲin/
wjelike	/ˈvʲɛlikʲɛ/
wjeliki	/ˈvʲɛlikʲi/
wjelk	/vʲɛlk/
wjerba	[ˈvʲɛrba]
włos	/wɔs/
włose	/ˈwɔsɛ/
Włoska	[ˈwɔska]
włosy	[ˈwɔsɨ]
wó	/wɨ/
wob	/ɔp/
wobjed	/ˈɔbʲɛt/
wobjedował	/ˈɔbʲɛdɔwaw/
wobjedowali	/ˈɔbʲɛdɔwali/
wobjedowaś	/ˈɔbʲɛdɔwaɕ/
woblico	/ˈɔblit͡sɔ/
wobraz	[ˈɔbras]
wobrośiś	[ˈɔbrɔɕiɕ]
wobwóco	/ˈɔbwɨt͡sɔ/
wobwócyjo	/ˈɔbwɨt͡sɨjɔ/
wóda	/ˈwɨda/
wódaj!	/ˈwɨdaj/
wódajśo!	/ˈwɨdajɕɔ/
wódajtej!	/ˈwɨdajtɛj/
wódce	/ˈwɨtt͡sɛ/
wódka	/ˈwɨtka/
wódkach	/ˈwɨtkax/
wódkami	/ˈwɨtkamʲi/
wódki	/ˈwɨtkʲi/
wódkow	/ˈwɨtkɔw/
wódy	/ˈwɨdɨ/
wogeń	/ˈɔɡʲɛnʲ/
woglěd	/ˈɔɡlɪt/
woglědaś	/ˈɔɡlɪdaɕ/
wogon	/ˈɔɡɛn/
wójak	/ˈwɛjak/
wójca	/ˈwɛjt͡sa/
wójowaŕ	/ˈwɛjowarʲ/
wójowaś	/ˈwɛjɔwaɕ/
woken	[ˈɔkʲɛn]
wokno	[ˈɔknɔ]
woko	/ˈɔkɔ/
wokoło	/ˈɔkɔwɔ/
wokuń	/ˈɔkunʲ/
woł	[ow]
wołaś	[ˈowaɕ]
wołojnik	[ˈowɔjnʲik]
wole	[ˈɔlɛ]
wólša	/ˈwɨlʃa/
wón	/wɨn/
wóna	/ˈwɨna/
wónej	/ˈwɨnɛj/
wóni	/ˈwɨnʲi/
wóno	/ˈwɨnɔ/
wopuchnuś	[ˈɔpuxnuɕ]
wopuchowaś	[ˈɔpuxowaɕ]
wórjech	/ˈwɨrʲɛx/
wós	/wɨs/
wósa	/ˈwɨsa/
wósach	/ˈwɨsax/
wósam	/ˈwɨsam/
wósami	/ˈwɨsami/
wóse	/ˈwɨsɛ/
wósebny	/ˈwɨsɛbnɨ/
wósk	/wɨsk/
wósoba	/ˈwɨsɔba/
wósoł	/ˈwɨsɔw/
wósoma	/ˈwɨsɔma/
wósow	/ˈwɨsɔw/
wósowu	/ˈwɨsɔwu/
wósu	/ˈwɨsu/
wósy	/ˈwɨsɨ/
wóśc	/wɨɕt͡s/
wót	/wɨt/
wóte	/ˈwɨtɛ/
wótergi	/ˈwɨtɛrɡʲi/
wótmólowany	/ˈwɨtmɨlɔwanɨ/
wótmólowaś	/ˈwɨtmɨlɔwaɕ/
wótšy	/ˈwɨt͡ʃɨ/
wows	[ows]
wóz	/wɨs/
wózu	/ˈwɨzu/
wózyk	/ˈwɨzɨk/
wózyś	/ˈwɨzɨɕ/
wrjeśeno	/ˈrʲɛɕɛnɔ/
wrobel	[ˈrɔbɛl]
wroblik	[ˈrɔblʲik]
wron	[rɔn]
wrona	[ˈrɔna]
wrota	[ˈrɔta]
wšake	/ˈʃakʲɛ/
wšaki	[ˈʃakʲi]
wšuźi	[ˈʃuʑi]
wšyken	/ˈʃɨkʲɛn/
wšykne	/ˈʃɨknɛ/
wšykno	/ˈʃɨknɔ/
wu	/u/
wu-	[u]
wucabnica	[ˈutsabnʲitsa]
wucabnik	[ˈutsabnʲik]
wuchac	/ˈuxat͡s/
wucho	/ˈuxɔ/
wucu	[ˈut͡su]
wucuś	[ˈutsuɕ]
wucyś	[ˈutsɨɕ]
wudra	/ˈudra/
wugoŕ	/ˈuɡɔrʲ/
wuknica	[ˈuknʲitsa]
wuknik	[ˈuknʲik]
wuknjo	[ˈuknʲɔ]
wuknjom	[ˈuknʲɔm]
wuknu	[ˈuknu]
wuknuł	[ˈuknuw]
wuknuś	[ˈuknuɕ]
wul	/ul/
wula	/Ëˆula/
wule	/ˈulɛ/
wulicowaś	/ˈulit͡sɔwaɕ/
wulk	/ulk/
wulu	/Ëˆulu/
wuměra	/ˈumʲɪra/
wuměraju	/ˈumʲɪraju/
wuměrał	/ˈumʲɪraw/
wuměram	/ˈumʲɪram/
wuměraś	/ˈumʲɪraɕ/
wumje	/ˈumʲɛ/
wumrějo	/ˈumrʲejɔ/
wumrějom	[ˈumrʲejɔm]
wumrěju	[ˈumrʲeju]
krowach	/Ëˆkrowax/
krowami	/ˈkrowamʲi/
krowy	/ˈkrowɨ/
Šwikawa	/ˈʃvʲikawa/
Mišnjo	/ˈmʲiʃnʲɔ/
Kamjenica	/ˈkamʲɛnʲit͡sa/
Frankobrod nad Odru	/ˈfrankɔbrɔt ˈnadɔdru/
ježe	/ˈjɛʒɛ/
Česka	/ˈtʃɛska/
Sakska	/ˈsakska/
bananu	/baˈnanu/
kobru	/ˈkɔbru/
kobry	/ˈkɔbrɨ/
kobrami	/ˈkɔbramʲi/
bruse	/ˈbrusɛ/
drapa	[ˈdrapa]
carna	[ˈt͡sarna]
duj	[duj]
ceje	/ˈt͡sɛjɛ/
segni	[ˈsɛɡnʲi]
wumrěł	/ˈumrʲɪw/
wumrěś	/ˈumrʲɪɕ/
wuski	[ˈuskʲi]
wusmjerśiś	[ˈusmʲɛrɕiɕ]
wusmjerśowaś	[ˈusmʲɛrɕowaɕ]
wusoki	[ˈusɔkʲi]
wutšoba	/ˈut͡ʃɔba/
wutšobnje	/ˈut͡ʃɔbnʲɛ/
wuž	/uʃ/
wužeńc	[ˈuʒɛnʲt͡s]
wy	/wɨ/
z	/z/
za	/za/
zajmowaś	/ˈzajmɔwaɕ/
zajtšo	[ˈzajtʃɔ]
zarz	/zars/
zarza	/Ëˆzarza/
zasej	/ˈzasɛj/
zasejwiźenje	/ˈzasɛjvʲiʑɛnʲɛ/
ze	/zɛ/
zeger	[ˈzɛɡʲɛr]
zelena	[ˈzɛlɛna]
zeleny	/ˈzɛlɛnɨ/
zeleń	[ˈzɛlʲenʲ]
zeleznica	/ˈzɛlɛznʲit͡sa/
zelezo	/ˈzɛlɛzɔ/
zemi	/ˈzɛmʲi/
zemiska	/ˈzɛmʲiska/
zemiskam	/ˈzɛmʲiskam/
zemiski	/ˈzɛmʲiskʲi/
zemisku	/ˈzɛmʲisku/
zemja	/ˈzɛmʲa/
zemju	/ˈzɛmʲu/
zgnity	/ˈzɡnʲitɨ/
Zgórjelc	/ˈzɡɛrʲɛlt͡s/
zła	[zwa]
złe	[zwɛ]
złego	/ˈzwɛɡo/
złej	/ˈzwɛj/
złemu	[ˈzwɛmu]
złota	/ˈzwɔta/
złote	/ˈzwɔtɛ/
złotego	/ˈzwɔtɛɡo/
złotej	/ˈzwɔtɛj/
złotemu	/ˈzwɔtɛmu/
złoto	/ˈzwɔtɔ/
złoty	/ˈzwɔtɨ/
złotych	/ˈzwɔtɨx/
złotym	/ˈzwɔtɨm/
złotymi	/ˈzwɔtɨmʲi/
zły	/zwɨ/
złych	[zwɨx]
złym	/zwɨm/
złymi	[ˈzwɨmʲi]
zmakaś	/ˈzmakaɕ/
zmija	[ˈzmʲija]
zmije	[ˈzmʲijɛ]
zmijica	[ˈzmʲijitsa]
znamje	/ˈznamʲɛ/
znaty	[ˈznatɨ]
zub	/zup/
zwěrje	/ˈzvʲɪrʲɛ/
zyma	/ˈzɨma/
zymnica	/ˈzɨmnʲit͡sa/
zymny	[ˈzɨmnɨ]
žaba	/ˈʒaba/
žeńska	/ˈʒɛnʲska/
žni	[ʒnʲi]
žołma	/ˈʒɔwma/
žołty	[ˈʒowtɨ]
žołw	/ʒow/
žołź	/ʒɔwɕ/
žona	/ˈʒɔna/
žorawa	/ˈʒɔrawa/
žrěbc	/ʒrʲɪpt͡s/
žrěbje	/ˈʒrʲɪbʲɛ/
žurnal	/ʒurˈnal/
žurnalist	/ʒurnaˈlist/
žurnalistka	/ʒurnaˈlistka/
žyś	/ʒɨɕ/
žyto	/ˈʒɨtɔ/
žywjenje	/ˈʒɨvʲɛnʲɛ/
žywot	[ˈʒɨwɔt]
žywy	/ˈʒɨwɨ/
źaržaś	/ˈʑarʒaɕ/
źeń	/ʑɛnʲ/
źěd	/ʑɪt/
źěkujom se	/ˈʑɪkujɔmsɛ/
źěkuju se	/ˈʑɪkujusɛ/
źěl	/ʑɪl/
źěłaś	/ˈʑɪwaɕ/
źěło	/ˈʑɪwɔ/
źěle	/ˈʑɪlɛ/
źěliś	/ˈʑɪlʲiɕ/
źěsna	/ˈʑɪsna/
źinsa	/ˈʑinsa/
źiśe	/ˈʑiɕɛ/
źiśecy	[ˈʑiɕɛt͡sɨ]
źiśelc	/ˈʑiɕelt͡s/
źiśi	/ˈʑiɕi/
źiwadło	[ˈʑiwadwo]
źom	/ʑɔm/
źomej	/ˈʑɔmɛj/
źomy	/ˈʑɔmɨ/
źoš	/ʑɔʃ/
źośo	/ˈʑɔɕɔ/
źotej	/ˈʑɔtɛj/
źowce	/ˈʑɔwt͡sɛ/
źowćo	/ˈʑowtɕɔ/
źowka	[ˈʑowka]
źož	[ʑɔʃ]
źurja	[ˈʑurʲa]
