hlave	[ˈɦlave]
denne	[ˈdene]
hora	[ˈɦora]
nosoch	[ˈnosox]
nosmi	[ˈnosmi]
koláčik	[ˈkolaːt͡ʃik]
koláčom	[ˈkolaːt͡ʃom]
koláču	[ˈkolaːt͡ʃu]
koláči	[ˈkolaːt͡ʃi]
koláča	[ˈkolaːt͡ʃa]
darovať	[ˈdarovac]
zaspať	[ˈzaspac]
na zdravie	[na zdravi̯e]
cestovať	[ˈt͡sestovac]
palec na nohe	[palet͡s na noɦe]
pieh	[pi̯ex]
pehy	[ˈpeɦi]
pehách	[ˈpeɦaːx]
pehám	[ˈpeɦaːm]
pohára	[ˈpoɦaːra]
ä	/e/
abbé	/ˈabbɛː/
abeceda	/ˈa.bɛ.t͡sɛ.da/
Ábel	/ˈaːbɛɫ/
Adam	/ˈa.dam/
Adama	/Ëˆadama/
Adamami	/ˈadamami/
Adamoch	/ˈadamɔx/
Adamom	/ˈadamɔm/
Adamov	/ˈadamɔu̯/
Adamovi	/ˈadamɔvi/
Adamovia	/ˈadamɔvi̯a/
Adela	/ˈadeɫa/
Adelka	/ˈadɛɫka/
adjektívum	/ˈadjɛktiːvum/
Ado	/ˈadɔ/
Adolf	/ˈadoɫf/
Adrián	/ˈadriaːn/
Adriána	/ˈadriaːna/
Afrika	/ˈafrika/
Afrikánec	/afrikaːɲɛt͡s/
Afrike	/ˈafrikɛ/
Afrikou	/ˈafrikɔu̯/
Afriku	/ˈafriku/
Afriky	/ˈafriki/
Agáta	/ˈaɡaːta/
Agnesa	/ˈaɡnɛsa/
ahoj	/ˈaɦɔj/
aids	/aː iː dɛː ɛs/
aj	[aj]
aj múdry schybí	/ˈaj muːdri sxibiː/
ak	/ak/
akcia	/ˈakt͡sia/
ako	/ˈakɔ/
akonáhle	/ˈakɔnaːɦlɛ/
aktínium	/ˈaktiːnium/
aktivovať	/ˈaktivovac/
aktualizácia	/ˈaktualizaːt͡sia/
aktualizovaný	/ˈaktualizovaniː/
aktualizovať	/ˈaktualizovac/
akuzatív	/ˈakuzatiːu̯/
aký	/ˈakiː/
akýkoľvek	/ˈakiːkɔʎvɛk/
Alah	/ˈaɫax/
Alan	/ˈaɫan/
Alánd	/ˈaɫaːnt/
Alandy	/ˈaɫandi/
Albánsko	[ˈalbaːnsko]
albánsky	/ˈaɫbaːnski/
albánčina	/ˈaɫbaːnt͡ʃina/
Albert	/ˈaɫbɛrt/
Albín	/ˈaɫbiːn/
Albína	/ˈaɫbiːna/
alebo	/ˈalɛbɔ/
Alena	/ˈalɛna/
Alexander	/ˈalɛksandɛr/
Alexandra	/ˈalɛksandra/
Alexej	/ˈalɛksɛj/
Aleš	/ˈalɛʃ/
Alfonz	/ˈaɫfɔns/
Alfréd	/ˈaɫfrɛːt/
alibi	/ˈalibi/
Alica	/ˈalit͡sa/
Aljaška	/ˈalʲaʃka/
alka	/ˈaɫka/
alkohol	/ˈaɫkɔɦɔɫ/
alkoholický	/ˈalkɔhɔlit͡skiː/
alkoholik	/ˈaɫkɔɦɔlik/
almanach	/ˈal.ma.nax/
Alojz	/ˈaɫɔjs/
Alpy	/ˈal.pi/
altruizmus	/ˈaɫtruizmus/
Alžbeta	/ˈaɫʒbɛta/
Amália	/ˈamaːlia/
Ambróz	/ˈambrɔs/
amerícium	/ˈamɛriːt͡sium/
americký	/ˈamɛrit͡skiː/
Američan	/ˈamɛrit͡ʃan/
Američanka	/ˈa.mɛ.ri.t͡ʃaŋ.ka/
amnézia	/ˈamnɛːzia/
Anabela	/ˈanabɛɫa/
anamnéza	/ˈanamnɛːza/
ananás	/ˈananaːs/
Anaxagoras	/ˈanaksaɡoras/
Andrea	/ˈandrɛa/
Andrej	/ˈandrɛj/
andulka	/ˈanduɫka/
Andy	[ˈandi]
Anežka	/ˈaɲɛʃka/
Angela	/ˈaŋɡɛɫa/
Angelika	/ˈaŋɡɛlika/
Anglicko	/ˈaŋɡlit͡skɔ/
angličtina	/ˈaŋɡlit͡ʃcina/
angström	/ˈaŋɡstrɛm/
ani	/ˈaɲi/
anjel	/ˈaɲi̯ɛɫ/
Anna	/ˈanna/
Annu	/ˈannu/
áno	/ˈaːnɔ/
antimón	/ˈantimɔːn/
antisemita	/ˈantisɛmita/
Anton	/ˈantɔn/
Antónia	/ˈantɔːnia/
aperitív	/ˈapɛritiːw/
apríl	/ˈapriːɫ/
arabčina	/ˈarapt͡ʃina/
aragonit	/ˈaraɡɔnit/
archeológia	/ˈarxɛɔɫɔːɡia/
architektúra	/ˈarxitɛktuːra/
arcibiskup	/ˈart͡sibiskup/
argón	/ˈarɡɔːn/
Aristoteles	/ˈaristɔtɛlɛs/
Arménsko	/ˈarmɛːnskɔ/
arménčina	/ˈarmɛːnt͡ʃina/
Arno	/ˈarnɔ/
Arnold	/ˈarnɔld/
Arpád	/ˈarpaːt/
artritída	/ˈartritiːda/
Artúr	/ˈartuːr/
arzén	/ˈarzɛːn/
astát	/ˈastaːt/
astronóm	/ˈastrɔnɔːm/
astronómia	/ˈastrɔnɔːmia/
ateizmus	/ˈatɛizmus/
Atény	/ˈatɛːni/
atóm	/ˈatɔːm/
atómový	/ˈatɔːmɔviː/
atrament	/ˈatramɛnt/
august	[ˈauɡust]
Augustín	/ˈau̯ɡustiːn/
Aurel	/ˈau̯rɛːɫ/
Aurélia	/ˈau̯rɛːlia/
áut	/ˈaːu̯t/
auta	/ˈau̯ta/
autách	/ˈau̯taːx/
autám	/ˈau̯taːm/
autami	/ˈau̯tami/
aute	/ˈau̯cɛ/
auto	/ˈau̯tɔ/
autobus	/ˈau̯tɔbus/
autom	/ˈau̯tɔm/
autostráda	/ˈau̯tɔstraːda/
autu	/ˈau̯tu/
azda	/ˈazda/
Ázia	/ˈaː.zi.a/
ázijský	/ˈaːzijskiː/
báb	/ˈbaːp/
baba	/ˈbaba/
bábika	/ˈbaːbika/
bábka	/ˈbaːbka/
bábok	/ˈbaːbɔk/
babona	/ˈbabɔna/
baht	/baːt/
bájka	[ˈbaːjka]
baktéria	/ˈbaktɛːria/
baktérie	/ˈbaktɛːriɛ/
baldrián	[ˈbaldriaːn]
Baleáry	/ˈbalɛaːri/
bambus	/ˈbambus/
bambusový	/ˈbambusɔviː/
banán	/ˈbanaːn/
baníctvo	/ˈbaɲiːt͡svɔ/
baník	/ˈbaɲiːk/
banka	/ˈbanka/
bankami	/ˈbaŋkami/
banke	/ˈbaŋkɛ/
bankomat	[Ëˆbankomat]
bankovka	/ˈbankɔu̯ka/
banku	/ˈbaŋku/
banky	/ˈbaŋki/
Bara	/ˈbara/
baran	[ˈbaran]
Barbara	/ˈbarbara/
Barbora	/ˈbarbɔra/
bárium	/ˈbaː.ri.um/
Bartolomej	/ˈbartɔɫɔmɛj/
báseň	/ˈbaːsɛɲ/
básnik	/ˈbaːsɲik/
bača	/ˈbat͡ʃa/
baňa	/ˈbaɲa/
báť sa	/ˈbaːc sa/
bažant	/ˈba.ʒant/
Beáta	/ˈbɛaːta/
Beátka	/ˈbɛaːtka/
bedminton	/ˈbɛːdmintɔn/
bedro	/ˈbɛːdrɔ/
bedňa	[ˈbedɲa]
beh	/ˈbɛx/
behať	/ˈbɛɦac/
Bejrút	/ˈbɛjruːt/
belasý	/ˈbelaˌsiː/
Belgicko	/ˈbɛɫɡit͡ʃkɔ/
Belo	/ˈbɛɫɔ/
Benjamín	/ˈbɛnjamiːn/
benzín	/ˈbɛnziːn/
benzínka	/ˈbɛnziːnka/
berkélium	/ˈbɛrkɛːlium/
Berlín	/ˈbɛrliːn/
Bernard	/ˈbɛrnard/
Berta	/ˈbɛrta/
hlave	[ˈɦlave]
denne	[ˈdene]
hora	[ˈɦora]
nosoch	[ˈnosox]
nosmi	[ˈnosmi]
koláčik	[ˈkolaːt͡ʃik]
koláčom	[ˈkolaːt͡ʃom]
koláču	[ˈkolaːt͡ʃu]
koláči	[ˈkolaːt͡ʃi]
koláča	[ˈkolaːt͡ʃa]
darovať	[ˈdarovac]
zaspať	[ˈzaspac]
na zdravie	[na zdravi̯e]
cestovať	[ˈt͡sestovac]
palec na nohe	[palet͡s na noɦe]
pieh	[pi̯ex]
pehy	[ˈpeɦi]
pehách	[ˈpeɦaːx]
pehám	[ˈpeɦaːm]
pohára	[ˈpoɦaːra]
berýlium	/ˈbɛriːlium/
Beskydy	/ˈbɛskidi/
beta	/ˈbɛta/
betón	/ˈbɛtɔːn/
bez	/ˈbɛs/
bezcharakterný	/ˈbɛsxaraktɛrniː/
beznádej	/ˈbɛznaːɟɛj/
bezo	/ˈbɛzɔ/
bezpečnosť	/ˈbɛspɛt͡ʃnɔsc/
Beňadik	/ˈbɛɲaɟik/
Beňo	/ˈbɛɲɔ/
bežať	/ˈbɛʒac/
Bianka	/ˈbi̯aŋka/
Bibiána	/ˈbibiaːna/
bicykel	/ˈbit͡sikɛɫ/
bielizeň	/ˈbi̯ɛlizɛɲ/
bielizník	/ˈbi̯ɛlizɲiːk/
Bielorusko	/ˈbi̯ɛɫɔruskɔ/
bieloruština	/ˈbi̯ɛɫɔruʃcina/
biely	/ˈbi̯ɛli/
biológia	/ˈbiɔɫɔːɡia/
biotit	/ˈbiotit/
birmovanie	/ˈbirmɔvaɲi̯ɛ/
birmovka	/ˈbirmɔu̯ka/
bisexualita	/ˈbisɛksualita/
biskup	/ˈbiskup/
bislama	/ˈbisɫama/
bizmut	/ˈbizmut/
Blahoslav	/ˈbɫaɦɔsɫau̯/
blamáž	/ˈblamaːʃ/
Blanka	/ˈbɫaŋka/
blázon	/ˈbɫaːzɔn/
Blažej	/ˈbɫaʒɛj/
Blažena	/ˈbɫaʒɛna/
blbaňa	[ˈbl̩baɲa]
bĺch	/ˈbɫ̩ːx/
blcha	/ˈbɫ̩.xa/
blen	[blen]
bližší	/ˈbliʃʃiː/
bobona	/ˈbɔbɔna/
bocian	/ˈbɔt͡si̯an/
bodka	/ˈbɔtka/
bodkočiarka	/ˈbɔtkɔˌt͡ʃi̯arka/
bodliak	/ˈbɔdli̯ak/
bodnúť	/ˈbɔdnuːc/
boh	/bɔx/
boha	[ˈboɦa]
bohatý	/ˈbɔɦatiː/
boháč	/ˈbɔɦaːt͡ʃ/
Bohdan	/ˈbɔɦdan/
Bohdana	/ˈbɔɦdana/
bohemizmus	/ˈbɔɦɛmizmus/
bohmi	[ˈboɦmi]
bohoch	[ˈboɦox]
bohom	[ˈboɦom]
bohov	[ˈboɦof]
bohovi	[ˈboɦovi]
bohovia	[ˈboɦovi̯a]
bohrium	/ˈbɔrium/
bohu	[ˈboɦu]
Bohumil	/ˈbɔɦumiɫ/
Bohumír	/ˈbɔɦumiːr/
Bohuslav	/ˈbɔɦuslau̯/
Bohuslava	/ˈbɔɦuslava/
Bohuš	/ˈbɔɦuʃ/
bohužiaľ	/ˈbɔɦuʒi̯aʎ/
bohyňa	/ˈboɦiɲa/
bojovať	/ˈbɔjɔvac/
Boleslav	/ˈbɔlɛslau̯/
bolesť	/ˈbɔlɛsc/
Bologna	/ˈboloɲa/
bomba	/ˈbɔmba/
bombardovať	/ˈbɔmbardɔvac/
Bonifác	/ˈbɔnifaːt͡s/
bór	/ˈbɔːr/
borec	/ˈbɔrɛt͡s/
Boris	/ˈbɔris/
borovicový	/ˈbɔrɔvit͡sɔviː/
bosorák	/ˈbɔsɔraːk/
botanika	/ˈbɔtanika/
botanizovať	/ˈbɔtanizɔvac/
bozk	/ˈbɔsk/
bozkať	/ˈbɔskac/
bôľ	/ˈbu̯ɔʎ/
bože	/bɔʒɛ/
Božena	/ˈbɔʒɛna/
Božica	/ˈbɔʒit͡sa/
Božidara	/ˈbɔʒidara/
božtek	/ˈbɔʃcɛk/
brada	/ˈbrada/
bradatý	/ˈbradatiː/
Branislav	/ˈbraɲisɫau̯/
Branislava	/ˈbraɲislava/
brány	/ˈbraːni/
brat	/brat/
brata	/Ëˆbrata/
Bratislava	[ˈbracislava]
Bratislave	/ˈbracisɫavɛ/
Bratislavou	/ˈbracisɫavɔu̯/
Bratislavu	/ˈbracisɫavu/
Bratislavy	/ˈbracisɫavi/
Bratislavčan	/ˈbracislau̯t͡ʃan/
bratranec	/ˈbratranet͡s/
brázda	/ˈbraːzda/
brazílski	/ˈbraziːɫski/
braček	/ˈbrat͡ʃɛk/
Braňa	/ˈbraɲa/
Braňo	/ˈbraɲɔ/
bŕd	/ˈbr̩ːt/
brdo	/ˈbr̩dɔ/
breh	/ˈbrɛx/
breza	/ˈbrɛza/
Brezina	[ˈbrezina]
brečtan	/ˈbrɛt͡ʃ.tan/
briadka	/ˈbri̯atka/
bridlica	[ˈbridlit͡sa]
Brigita	/ˈbriɡita/
Brita	/ˈbrita/
Brne	[brne]
bróm	/ˈbrɔːm/
Bronislava	/ˈbrɔɲislava/
broskyňa	/ˈbrɔskiɲa/
brucho	/ˈbruxɔ/
bruchomluvec	/ˈbruxɔˌmluvɛt͡s/
brunet	[ˈbrunet]
bruneta	[ˈbruneta]
brunetka	[ˈbrunetka]
Bruno	/ˈbrunɔ/
Brusel	/ˈbrusɛɫ/
bruško	/ˈbruʃkɔ/
bryndza	/ˈbrin.d͡za/
bŕzd	/ˈbr̩ːst/
brzda	/ˈbr̩zda/
bršlen	[ˈbr̩ʃlen]
bubon	[ˈbubon]
Budapešť	/ˈbudapɛʃc/
budova	/ˈbudɔva/
budúci	/ˈbuduːt͡si/
Budyšín	/ˈbudiʃiːn/
Bukurešť	/ˈbukurɛʃc/
Bulharsko	/ˈbuɫɦarskɔ/
bulharčina	/ˈbuɫɦart͡ʃina/
bunda	/bunda/
Bydgoszcz	/ˈbidɡɔʃt͡ʃ/
bystrica	/ˈbistrit͡sa/
Bystrík	/ˈbistriːk/
bystrý	/ˈbistriː/
byt	/Ëˆbit/
byvol	[ˈbivol]
byť	/bic/
cadik	/ˈt͡sadik/
cap	/ˈt͡sap/
capina	/ˈt͡sapina/
cár	/ˈt͡saːr/
Carihrad	/ˈt͡ʃariˌɦrat/
cárovič	/ˈt͡saːrɔvit͡ʃ/
cárovná	[ˈt͡saːrovnaː]
cech	/ˈt͡sɛx/
Cecília	/ˈtse̞tsiːɫia/
celá	[ˈt͡selaː]
celé	[ˈt͡seleː]
celebrita	/ˈt͡sɛlɛbrita/
celého	[ˈt͡seleːɦo]
celej	[ˈt͡selej]
celému	[ˈt͡seleːmu]
celiakia	/ˈt͡sɛliakia/
celom	[ˈt͡selom]
celou	[ˈt͡selou]
celú	[ˈt͡seluː]
celých	[ˈt͡seliːx]
celým	[ˈt͡seliːm]
celými	[ˈt͡seliːmi]
cena	/ˈt͡sɛna/
cencúľ	/ˈt͡sɛnt͡suːʎ/
cenník	/ˈt͡sɛnɲiːk/
cep	/t͡sɛp/
cér	/ˈt͡sɛːr/
ceruza	/ˈtsɛruza/
ceruzka	/ˈt͡sɛruska/
cesta	/ˈt͡sɛsta/
cestár	/ˈt͡sɛstaːr/
cesto	/ˈt͡sɛstɔ/
cestovateľ	/ˈt͡sɛstɔvacɛʎ/
cestovať	[ˈt͡sestovac]
cestovina	/ˈt͡sɛstɔvina/
cez	/ˈt͡sɛz/
cézium	/ˈtseː.zi.um/
ch	/x/
chalan	/ˈxaɫan/
chameleón	/ˈxamɛlɛɔːn/
charakter	/ˈxaraktɛr/
chémia	/ˈxɛːmia/
chí	/ˈxiː/
chladný	/ˈxɫadniː/
hlave	[ˈɦlave]
denne	[ˈdene]
hora	[ˈɦora]
nosoch	[ˈnosox]
nosmi	[ˈnosmi]
koláčik	[ˈkolaːt͡ʃik]
koláčom	[ˈkolaːt͡ʃom]
koláču	[ˈkolaːt͡ʃu]
koláči	[ˈkolaːt͡ʃi]
koláča	[ˈkolaːt͡ʃa]
darovať	[ˈdarovac]
zaspať	[ˈzaspac]
na zdravie	[na zdravi̯e]
cestovať	[ˈt͡sestovac]
palec na nohe	[palet͡s na noɦe]
pieh	[pi̯ex]
pehy	[ˈpeɦi]
pehách	[ˈpeɦaːx]
pehám	[ˈpeɦaːm]
pohára	[ˈpoɦaːra]
chlapec	/ˈxɫa.pɛt͡s/
chlapi	/ˈxɫapi/
chlapmi	/ˈxɫapmi/
chlapoch	/ˈxɫapɔx/
chlapov	/ˈxɫapɔu̯/
chleba	/ˈxlɛba/
	
chlm	/ˈxɫ̩m/
chlór	/ˈxɫɔːr/
chlp	/ˈxɫ̩p/
chodidlo	/ˈxɔɟidɫɔ/
chodiť	/ˈxɔɟic/
chodník	/ˈxɔdɲiːk/
cholera	/ˈxɔlɛra/
choroba	/ˈxɔrɔba/
chorobe	[ˈxorobe]
chorobný	/ˈxɔrɔbniː/
chorom	[ˈxorom]
chorou	/ˈxɔrɔu̯/
Chorvát	[ˈxorvaːt]
Chorvátsko	/ˈxɔrvaːtskɔ/
chorý	/ˈxɔriː/
Chovanec	[ˈxovanet͡s]
chrapkáč poľný	[xrapkaːt͡ʃ poʎniː]
chrbát	/ˈxr̩baːt/
chrbtica	/ˈxr̩pcit͡sa/
chren	/ˈxrɛn/
chrípka	/ˈxriːpka/
chrobák	/ˈxrɔbaːk/
chróm	/ˈxroːm/
chrupka	[ˈxrupka]
chrúst	/ˈxruːst/
chudobný	/ˈxudɔbniː/
Chudý	[ˈxudiː]
chuj	/ˈxuj/
chujovina	/ˈxujɔvina/
chuligán	/ˈxuliɡaːn/
chvastúň	/ˈxvastuːɲ/
chvíľa	/ˈxviːʎa/
chvíľka	/ˈxviːʎka/
chvíľočka	/ˈxviːʎɔt͡ʃka/
chvost	/ˈxvɔst/
chýr	/ˈxiːr/
chyža	/ˈxi.ʒa/
cibuľa	/ˈt͡sibuʎa/
cica	/ˈt͡sit͡sa/
cicavec	/ˈt͡sit͡savɛt͡s/
cicka	/ˈt͡sit͡ska/
cieľ	/ˈt͡si̯ɛʎ/
cigara	/ˈt͡siɡara/
cigareta	/ˈt͡siɡarɛta/
cikať	/ˈt͡sikac/
cín	/ˈt͡siːn/
cisár	/ˈt͡sisaːr/
citoslovce	/ˈt͡sitɔsɫɔvt͡sɛ/
cmar	/ˈt͡smar/
cnosť	/ˈt͡snɔsc/
cól	/ˈt͡sɔːɫ/
cop	[t͡sop]
cti	/ˈtsci/
ctí	/ˈt͡sciː/
Ctibor	/ˈt͡scibɔr/
Cuda	/t͡su.da/
cudzí	/ˈt͡sud͡ziː/
cudzinec	/ˈt͡sud͡ziɲɛt͡s/
cudzinka	/ˈt͡sud͡ziŋka/
cukor	/ˈt͡sukɔr/
cunami	/ˈt͡su.na.mi/
curium	/ˈkyrium/
cvikla	/ˈt͡svikla/
Cyprián	/ˈt͡sipriaːn/
Cyril	/ˈt͡siriɫ/
Dalibor	/ˈdalibɔr/
Dalimil	/ˈdalimiɫ/
dáma	/ˈdaːma/
Damask	/ˈdamask/
Dán	/ˈdaːn/
Dana	/ˈdana/
dani	/ˈdaɲi/
Danica	/ˈdaɲit͡sa/
Daniel	/ˈdaniɛɫ/
Daniela	/ˈdaɲiela/
Danka	/ˈdaŋka/
Dánka	/ˈdaːŋka/
Dano	/ˈdanɔ/
Dánsko	/ˈdaːnskɔ/
dánsky	/ˈdaːnski/
Danuta	/ˈdanuta/
dánčina	/ˈdaːnt͡ʃina/
Dardanely	/ˈdardanɛli/
darmstadtium	/ˈdarmʃtatium/
darovať	[ˈdarovac]
darvinovský	[ˈdarvinovskiː]
databáza	/ˈdatabaːza/
daň	/daɲ/
Daňo	/ˈdaɲɔ/
Dáša	/ˈdaːʃa/
dať	/ˈdac/
dážď	/daːʃc/
dcéra	/ˈt͡sɛː.ra/
dcérka	/ˈt͡sɛːr.ka/
dcérsky	/ˈt͡sɛːrski/
deaktivovať	/ˈdɛaktivɔvac/
debna	/ˈɟɛbna/
december	/ˈdɛt͡sɛmbɛr/
dedina	/ˈɟɛɟina/
dedinôčka	/ˈɟɛɟinu̯ɔt͡ʃka/
dedinčan	/ˈɟɛɟɪntʃan/
dedinčania	[ˈɟeɟint͡ʃaɲi̯a]
dedko	/ˈɟɛtkɔ/
dedo	/ˈɟɛdɔ/
Dedo Mráz	/ˈɟɛdɔ mraːs/
deizmus	/ˈdɛizmus/
dejepis	/ˈɟɛjɛpis/
delfín	/ˈdɛlfiːn/
Demeter	/ˈdɛmɛtɛr/
Denis	/ˈdɛnis/
Denisa	/ˈdɛnisa/
denne	[ˈdene]
denník	/ˈɟɛnɲiːk/
denný	/ˈɟɛnniː/
derviš	/ˈdɛrviʃ/
desať	/ˈɟɛsac/
desaťtisíci	[ˈdesactisiːt͡si]
desiaty	/ˈɟɛsi̯ati/
determinant	/ˈdɛtɛrminant/
deti	/ˈɟɛci/
detí	/ˈɟɛciː/
detská mozgová obrna	/ˈɟɛtskaː mɔzɡɔvaː ɔbr̩na/
detská obrna	/ˈɟɛtska ɔbr̩na/
deva	/ˈɟɛva/
deväťsil	[ˈdevæcsil]
Dezider	/ˈdɛzidɛr/
deň	/ɟɛɲ/
deťmi	[ˈdecmi]
diabol	/ˈɟi̯abɔɫ/
Diana	/ˈdiana/
diaľnica	/ˈɟi̯aʎɲit͡sa/
Dido	[ˈdido]
dielo	/ˈɟi̯ɛɫɔ/
diéta	/ˈdi.ɛː.ta/
dievča	/ˈɟi̯ɛu̯t͡ʃa/
dieťa	[ˈdi̯eca]
Dionýz	/ˈdioniːs/
diviak	[ˈdivi̯ak]
divozel	[ˈdivozel]
dlátko	/ˈdɫaːtkɔ/
dláto	/ˈdɫaːtɔ/
dlaň	/ˈdɫaɲ/
dlh	/dɫ̩x/
dlhý	/ˈdl̩ɦiː/
dĺžeň	/ˈdɫ̩ːʒɛɲ/
dne	/dɲɛ/
dnes	/dɲɛs/
dni	/ˈdɲi/
dní	/ˈdɲiː/
do	/ˈdɔ/
do frasa	[do frasa]
hlave	[ˈɦlave]
denne	[ˈdene]
hora	[ˈɦora]
nosoch	[ˈnosox]
nosmi	[ˈnosmi]
koláčik	[ˈkolaːt͡ʃik]
koláčom	[ˈkolaːt͡ʃom]
koláču	[ˈkolaːt͡ʃu]
koláči	[ˈkolaːt͡ʃi]
koláča	[ˈkolaːt͡ʃa]
darovať	[ˈdarovac]
zaspať	[ˈzaspac]
na zdravie	[na zdravi̯e]
cestovať	[ˈt͡sestovac]
palec na nohe	[palet͡s na noɦe]
pieh	[pi̯ex]
pehy	[ˈpeɦi]
pehách	[ˈpeɦaːx]
pehám	[ˈpeɦaːm]
pohára	[ˈpoɦaːra]
do paroma	[do paroma]
do piče!	[do pit͡ʃe]
do videnia	[do videni̯a]
dobrá	/ˈdɔbraː/
dobre	/ˈdɔbrɛ/
dobré	/ˈdɔbrɛː/
dobré ráno	/ˈdɔbrɛː raːnɔ/
dobrého	/ˈdɔbrɛːɦɔ/
dobrej	/ˈdɔbrɛj/
dobrému	/ˈdɔbrɛːmu/
dobrí	/ˈdɔbriː/
Dobromil	/ˈdɔbrɔmiɫ/
Dobromila	/ˈdɔbrɔmiɫa/
Dobroslav	/ˈdɔbrɔsɫau̯/
Dobroslava	/ˈdɔbrɔsɫava/
dobrú	/ˈdɔbruː/
dobrý	/ˈdɔbriː/
dobrý deň	/dɔbriː ɟɛɲ/
dobrými	/ˈdɔbriːmi/
dofrasa	[ˈdofrasa]
dojča	/ˈdɔjt͡ʃa/
dokázať	/ˈdɔkaːzac/
doktor	/ˈdɔktɔr/
doktora	/ˈdɔktɔra/
doktormi	/ˈdɔktɔrmi/
doktoroch	/ˈdɔktɔrɔx/
doktorom	/ˈdɔktɔrɔm/
doktorov	/ˈdɔktɔrɔu̯/
doktorovi	/ˈdɔktɔrɔvi/
dôležitý	/ˈdu̯ɔlɛʒitiː/
dolinôčka	/ˈdɔlinu̯ɔt͡ʃka/
dom	/ˈdɔm/
doma	/ˈdɔma/
domáci	/ˈdɔmaːt͡si/
domami	[ˈdomami]
dome	[Ëˆdome]
Dominik	/ˈdɔminik/
Dominika	/ˈdɔminika/
Dominikánska republika	/ˈdɔminikaːnska republika/
dominikánsky	/ˈdɔminikaːnski/
domoch	[ˈdomox]
domom	[ˈdomom]
domorodec	/ˈdɔmɔrɔɟɛt͡s/
domov	/ˈdɔmɔu̯/
domu	[Ëˆdomu]
domček	/ˈdɔmt͡ʃɛk/
doparoma	[ˈdoparoma]
dopyt	/ˈdɔpit/
Dorota	/ˈdɔrɔta/
dosiaľ	/ˈdɔsi̯aʎ/
dostať	/ˈdɔstac/
dôstojný	/ˈdu̯ostojniː/
doteraz	/ˈdɔtɛras/
dovidenia	[ˈdovideni̯a]
dovolenka	/ˈdɔvɔlɛŋka/
Dráh	[draːx]
Draha	/ˈdraɦa/
Drahami	[ˈdraɦami]
Drahe	[ˈdraɦe]
drahí	[ˈdraɦiː]
drahokam	/ˈdraɦɔkam/
Drahoslav	/ˈdraɦɔsɫau̯/
Drahou	[ˈdraɦou]
Drahoš	/ˈdraɦɔʃ/
Drahu	[ˈdraɦu]
Drahuša	/ˈdrahuʃa/
Drahy	[ˈdraɦi]
draslík	/ˈdrasliːk/
dráčik	/ˈdraːt͡ʃik/
Drážďany	/ˈdraːʒɟani/
drez	[dres]
drieň	[dri̯eɲ]
drozd	/ˈdrɔst/
drozdí	/ˈdrɔzɟiː/
drumbľa	/ˈdrumbʎa/
drviť	/ˈdr̩vic/
dŕžava	/dr̩ːʒava/
dŕžavní	/ˈdr̩ːʒavniː/
držať	/ˈdr̩ʒac/
dub	/ˈdup/
duba	/Ëˆduba/
dube	/ˈdubɛ/
dubmi	/ˈdubmi/
dubnium	/Ëˆdubnium/
duboch	/ˈdubɔx/
dubom	/ˈdubɔm/
dubov	/ˈdubɔu̯/
dubu	/Ëˆdubu/
duby	/ˈdubi/
dudy	/ˈdudi/
dúha	/ˈduːɦa/
dúhe	[ˈduːɦe]
Dunaj	/ˈdunaj/
Dunajec	/ˈdunajɛt͡s/
dunajskí	/ˈdunajskiː/
dunajský	/ˈdunajskiː/
dunčo	/ˈdunt͡ʃɔ/
dusík	/ˈdusiːk/
duša	/ˈduʃa/
Duša	/ˈduʃa/
Dušan	/ˈduʃan/
Dušana	/ˈduʃana/
duše	/ˈduʃɛ/
dva	/ˈdva/
dvadsať	/ˈdvatsac/
dvaja	/ˈdva.ja/
dvakrát	/ˈdvakraːt/
dvanásť	/ˈdvanaːsc/
dvanásťročný	/ˈdvanaːscrɔt͡ʃniː/
dvere	/ˈdvɛrɛ/
dvojhláska	[ˈdvojɦlaːska]
dvojitý	/ˈdvɔjitiː/
dýchať	/ˈdiːxac/
dym	/ˈdim/
dymami	/ˈdimami/
dyme	/ˈdimɛ/
dymoch	/ˈdimɔx/
dymom	/ˈdimɔm/
dymov	/ˈdimɔu̯/
dymu	/ˈdimu/
dymy	/ˈdimi/
dysprózium	/ˈdisprɔːzium/
dž	/d͡ʒ/
Dž	/d͡ʒ/
džamija	/ˈd͡ʒa.mi.ja/
džbán	/ˈd͡ʒbaːn/
džem	/ˈd͡ʒɛm/
džez	/ˈd͡ʒɛs/
džin	/d͡ʒin/
džíp	/ˈd͡ʒiːp/
džudo	/ˈdʒudo/
džungľa	/ˈd͡ʒuŋɡʎa/
džús	/ˈd͡ʒuːs/
Edmund	/ˈɛdmund/
egreš	/ˈɛɡrɛʃ/
Egypt	/ˈɛɡipt/
einsteinium	/ˈajnʃtajnium/
Ela	/ˈɛɫa/
elektromagnetická interakcia	/ˈɛlɛktrɔmaɡnɛtit͡skaː intɛrakt͡sia/
elektromagnetický	/ˈɛlɛktrɔmaɡnɛtit͡skiː/
Eleonóra	/ˈɛlɛɔnɔːra/
Eliška	/ˈɛliʃka/
Elvíra	/ˈɛlviːra/
Ema	/ˈɛma/
Emanuel	/ˈɛmanuɛɫ/
embólia	/ˈɛmbɔːlia/
Emil	/ˈɛmiɫ/
encyklopédia	/ˈɛnt͡siklɔpɛːdia/
Epikuros	/ˈɛpikurɔs/
Epir	/ˈɛpir/
erb	/ˈɛrb/
Erik	/ˈɛrik/
Ernest	/ˈɛrnɛst/
Erno	/ˈɛrnɔ/
Esbjerg	/ˈɛzbjɛr/
esej	/ˈɛsɛj/
Ester	/ˈɛstɛr/
estónčina	/ˈɛstɔːnt͡ʃina/
Eta	/ˈɛta/
Etela	/ˈɛtɛɫa/
hlave	[ˈɦlave]
denne	[ˈdene]
hora	[ˈɦora]
nosoch	[ˈnosox]
nosmi	[ˈnosmi]
koláčik	[ˈkolaːt͡ʃik]
koláčom	[ˈkolaːt͡ʃom]
koláču	[ˈkolaːt͡ʃu]
koláči	[ˈkolaːt͡ʃi]
koláča	[ˈkolaːt͡ʃa]
darovať	[ˈdarovac]
zaspať	[ˈzaspac]
na zdravie	[na zdravi̯e]
cestovať	[ˈt͡sestovac]
palec na nohe	[palet͡s na noɦe]
pieh	[pi̯ex]
pehy	[ˈpeɦi]
pehách	[ˈpeɦaːx]
pehám	[ˈpeɦaːm]
pohára	[ˈpoɦaːra]
Eufrat	/ˈɛu̯frat/
Eugen	/ˈɛu̯ɡɛn/
Eugénia	/ˈɛu̯ɡɛːnia/
euro	/ˈɛu̯rɔ/
Európa	/ˈɛu̯rɔːpa/
Európe	/ˈɛu̯rɔːpɛ/
európium	/ˈɛu̯rɔːpium/
Európou	/ˈɛu̯rɔːpɔu̯/
Európska únia	/ˈɛu̯rɔːpska uːnia/
Európu	/ˈɛu̯rɔːpu/
Európy	/ˈɛu̯rɔːpi/
Eva	/ˈɛva/
evanjelium	/ˈɛ.va.ɲi̯ɛ.li.um/
Exodus	/ˈɛksɔdus/
extáza	/ˈɛkstaːza/
Ezdráš	/ˈɛzdraːʃ/
Faerská plytčina	/ˈfaɛrskaː plitt͡ʃina/
Faerské ostrovy	/faɛrskɛː ɔstrɔvɪ/
faerský	/ˈfa.ɛr.skiː/
Faerčan	/ˈfaɛrt͡ʃan/
Faerčanka	/ˈfaɛrt͡ʃaŋka/
fagot	/ˈfaɡɔt/
fajka	/ˈfajka/
fajčiar	/ˈfajt͡ʃi̯ar/
fakt	/fakt/
faktami	/faktami/
fakte	/fakce/
faktoch	/faktox/
faktom	/faktom/
faktov	/faktou̯/
faktu	/faktu/
fakty	/fakti/
fakľa	/ˈfakʎa/
fám	/ˈfaːm/
farba	/ˈfar.ba/
farbu	/ˈfarbu/
farmakológia	/ˈfarmakɔlɔːɡia/
fazuľa	/ˈfazuʎa/
fašistický	/ˈfaʃistit͡skiː/
fašizmus	/ˈfaʃizmus/
február	/ˈfɛbruaːr/
Félix	/ˈfɛːliks/
fén	/fɛːn/
Fenícia	/ˈfeniːt͡sia/
Ferdinand	/ˈfɛrdinand/
fermium	/ˈfɛrmium/
Fero	/ˈfɛrɔ/
feudalizmus	/ˈfɛu̯dalizmus/
fí	/ˈfiː/
Fidži	/ˈfid͡ʒi/
figa	/ˈfiɡa/
figovník	/ˈfiɡɔu̯ɲiːk/
Filip	/ˈfilip/
film	/ˈfiɫm/
Filoména	/ˈfilɔmɛːna/
filozofia	/ˈfilɔzɔfia/
Fín	/ˈfiːn/
finále	/ˈfinaːlɛ/
finančný	/ˈfinant͡ʃniː/
Fínsko	/ˈfiːnskɔ/
fínsky	/ˈfiːnski/
fínčina	/ˈfiːnt͡ʃina/
fjord	/ˈfjɔrd/
flauta	/ˈfɫau̯ta/
flerovium	/ˈflɛrɔvium/
fliačik	/ˈfʎi̯at͡ʃik/
Florián	/ˈfɫɔriaːn/
Florida	/ˈflo.ri.da/
fluór	/ˈfluɔːr/
fonéma	/ˈfɔnɛːma/
fosfor	/ˈfɔsfɔr/
fotogenický	/ˈfɔtɔɡɛnit͡skiː/
fotograf	/ˈfɔtɔɡraf/
fotografií	/ˈfɔtɔɡrafiiː/
fotografista	/ˈfɔtɔɡrafista/
foyer	/ˈfɔajɛː/
Frano	[ˈfrano]
František	/ˈfran.ci.ʃɛk/
Františka	/ˈfrancɪʃka/
Frederik	/ˈfrɛdɛrik/
Fridrich	/ˈfridrix/
fruštik	/ˈfruʃcik/
fujara	/ˈfujara/
fujarôčka	/ˈfujaru̯ɔt͡ʃka/
futbal	/ˈfudbaɫ/
fyzika	/ˈfi.zi.ka/
fyzikálny	/ˈfizikaːlni/
fön	/føn/
fľaša	/ˈfʎaʃa/
Gabriel	/ˈɡabriɛɫ/
Gabriela	/ˈɡabriɛɫa/
gadolínium	/ˈɡadɔliːnium/
galaxia	[ˈɡalaksi̯a]
galaxiám	/ˈɡa.lak.si.aːm/
galaxiami	/ˈɡa.lak.si.a.mi/
galaxie	/ˈɡa.lak.si.e/
galaxii	[ˈɡalaksii]
galaxií	/ˈɡa.lak.si.iː/
galaxiou	/ˈɡa.lak.si.ou̯/
galaxiu	/ˈɡa.lak.si.u/
Galina	/ˈɡalina/
gálium	/ˈɡaːlium/
garbiar	/ˈɡarbi̯ar/
Gaskonsko	/ɡaskɔnskɔ/
gauč	/ˈɡau̯t͡ʃ/
gazda	/ˈɡazda/
gazdiná	/ˈɡazɟinaː/
gazdinka	/ˈɡazɟiŋka/
Gašpar	/ˈɡaʃpar/
Gdansk	/ɡdansk/
Gdynia	/ɡdiɲa/
Gejza	/ˈɡɛjza/
Genovéva	/ˈɡɛnɔvɛːva/
geológia	/ˈɡɛɔlɔːɡia/
georgína	/ˈɡɛɔrɡiːna/
Georgína	/ˈɡɛɔrɡiːna/
germánium	/ˈɡɛrmaːnium/
Gertrúda	/ˈɡɛrtruːda/
gibon	/ˈɡibɔn/
Gizela	/ˈɡizɛɫa/
glg	/ɡɫ̩k/
glóbus	/ˈɡɫɔːbus/
glukózový sirup	/ˈɡɫukɔːzɔviː sirup/
gól	/ˈɡoːɫ/
golier	/ˈɡɔʎi̯ɛr/
gombík	/ˈɡɔmbiːk/
Graz	/ɡrat͡s/
grécky	/ˈɡrɛːtski/
Gregor	/ˈɡrɛɡɔr/
Grékyňa	/ˈɡrɛːkiɲa/
gréčtina	/ˈɡrɛːt͡ʃcina/
grinde	/ˈɡrinɟɛ/
Grónsko	/ˈɡrɔːnskɔ/
Gruzínsko	[ˈɡruziːnsko]
guru	/ˈɡu.ru/
Gustáv	/ˈɡustaːu̯/
guľa	/ˈɡuʎa/
gýč	/ɡiːt͡ʃ/
Győr	/ˈɟøːr/
had	/ˈɦat/
hadoch	[ˈɦadox]
hadom	[ˈɦadom]
hadovi	[ˈɦadovi]
hadž	/ˈɦat͡ʃ/
hafnium	/ˈɦafnium/
hala	/ˈɦaɫa/
halier	/ˈɦaʎi̯ɛr/
Hana	/ˈɦana/
handra	/ˈɦandra/
Hanoj	/ˈɦanɔj/
harmanček	/ˈɦarmant͡ʃɛk/
haruspex	/ˈɦaruspeks/
Harvan	[ˈɦarvan]
hassium	/ˈɦasium/
Havaj	/ˈɦavaj/
havran	/ˈɦavran/
hebrejčina	/ˈɦɛbrɛjt͡ʃina/
hej	/ˈɦɛj/
Helena	/ˈɦɛlɛna/
hlave	[ˈɦlave]
denne	[ˈdene]
hora	[ˈɦora]
nosoch	[ˈnosox]
nosmi	[ˈnosmi]
koláčik	[ˈkolaːt͡ʃik]
koláčom	[ˈkolaːt͡ʃom]
koláču	[ˈkolaːt͡ʃu]
koláči	[ˈkolaːt͡ʃi]
koláča	[ˈkolaːt͡ʃa]
darovať	[ˈdarovac]
zaspať	[ˈzaspac]
na zdravie	[na zdravi̯e]
cestovať	[ˈt͡sestovac]
palec na nohe	[palet͡s na noɦe]
pieh	[pi̯ex]
pehy	[ˈpeɦi]
pehách	[ˈpeɦaːx]
pehám	[ˈpeɦaːm]
pohára	[ˈpoɦaːra]
Helga	/ˈɦɛɫɡa/
heliometer	/ˈɦɛliɔmɛtɛr/
hélium	/ˈɦɛːlium/
Helsinki	/ˈɦɛɫsiŋki/
hematológia	/ɦɛmatɔlɔːɡɪja/
hemendex	/ˈɦɛmɛndɛks/
Henrich	/ˈɦɛnrix/
Henrieta	/ˈɦɛnri̯ɛta/
hentam	/ˈɦɛntam/
heraldika	/ˈɦɛraɫdika/
herci	[ˈɦert͡si]
hercoch	[ˈɦert͡sox]
hercom	[ˈɦert͡som]
hercov	[ˈɦert͡sof]
Herkules	/ˈɦɛrkulɛs/
heterosexualita	/ˈɦɛtɛrɔsɛksualita/
hier	/ɦi̯er/
hierarchia	/ˈɦi̯ɛrarxia/
Hilda	/ˈɦiɫda/
hlad	/ˈɦɫat/
hlahol	/ˈɦɫaɦɔɫ/
hlaholika	/ˈɦɫaɦɔlit͡sa/
hlas	/ɦɫas/
hlave	[ˈɦlave]
hlavní	/ˈɦɫavniː/
hĺbkomer	/ɦɫ̩ːpkɔmɛr/
hlina	/ɦlina/
hliník	/ˈɦliɲiːk/
hlísta	[ˈɦliːsta]
hloh	/ˈɦɫɔx/
hmla	/ˈɦmɫa/
hmotnosť	/ˈɦmɔtnɔsc/
hnedý	/ˈɦɲɛdiː/
hnida	/ˈɦɲida/
hniezdo	/ɦɲi̯ɛzdɔ/
hnilý	/ˈɦɲiliː/
hnutí	/ˈɦnuciː/
ho	/ˈɦɔ/
hoci	/ˈɦɔt͡si/
hod	/ˈɦɔt/
hodina	/ˈɦɔɟina/
hodža	/ˈhɔ.d͡ʒa/
Hodžová	/ˈhɔ.d͡ʒɔ.vaː/
hojdacia sieť	/ˈɦɔjdat͡si̯a si̯ɛc/
hojdačka	/ˈɦɔjdat͡ʃka/
holá	[ˈɦolaː]
Holandsko	/ˈɦɔɫandskɔ/
holandsky	/ˈɦɔɫandski/
holandský	/ˈɦɔɫandskiː/
holandčina	/ˈɦɔɫandt͡ʃina/
hole	[ˈɦole]
holé	[ˈɦoleː]
holej	[ˈɦolej]
holi	[ˈɦoli]
holí	/ˈɦɔ.ʎiː/
holmium	/ˈɦɔɫmium/
holom	[ˈɦolom]
holú	[ˈɦoluː]
holub	/ˈɦɔɫup/
holubí	/ˈɦɔɫubiː/
holý	/ˈɦɔɫiː/
Holý	[ˈɦoliː]
homár	/ˈhomaːr/
homosexualita	/ˈɦɔmɔsɛksualita/
hora	[ˈɦora]
horizont udalostí	/ˈɦɔrizɔnt udalɔsciː/
horkí	[ˈɦorkiː]
horkú	[ˈɦorkuː]
hôrku	[ˈɦu̯orku]
horký	/ˈɦɔrkiː/
hôrky	[ˈɦu̯orki]
hôrok	[ˈɦu̯orok]
Hortenzia	/ˈɦɔrtɛnzia/
horúci	/ˈɦɔruːt͡si/
horúčava	/ˈɦɔruːt͡ʃava/
horčík	/ˈɦɔrt͡ʃiːk/
horší	/ˈɦɔrʃiː/
hosť	/ˈɦɔsc/
hovädina	/ˈɦɔvæɟina/
hovädo	/ˈɦɔvɛdɔ/
hovädzí	/ˈɦɔvæd͡ziː/
hovädzie	/ˈɦɔvɛd͡zi̯ɛ/
hovno	/ˈɦɔvnɔ/
hovoriť	/ˈɦɔvɔric/
hôľ	/ɦu̯oʎ/
hoľa	/ˈɦo.ʎa/
hra	/ˈɦra/
hrab	/ˈɦrap/
hrach	/ˈɦrax/
hrad	/ˈɦrat/
hradba	/ˈɦradba/
hranica	/ˈɦraɲit͡sa/
hranice	/ˈɦraɲit͡sɛ/
hrať	/ˈɦrac/
hrb	/ˈɦr̩p/
hŕb	/ɦr̩ːp/
hrdina	/ˈɦr̩ɟina/
hrdinami	/ˈɦr̩ɟinami/
hrdinoch	/ˈɦr̩ɟinɔx/
hrdinom	/ˈɦr̩ɟinɔm/
hrdinov	/ˈɦr̩ɟinɔu̯/
hrdinovi	/ˈɦr̩ɟinɔvi/
hrdinu	/ˈɦr̩ɟinu/
hrdý	/ˈɦr̩diː/
hre	[ɦre]
hrianka	/ˈɦr̩i̯aŋka/
hriech	/ɦri̯ex/
hrivna	/ˈɦrivna/
hroch	/ˈɦrɔx/
hrozienko	/ˈɦrɔzi̯ɛŋkɔ/
hrozný	/ˈɦrɔzniː/
hrsť	/ɦr̩sc/
hrudní	/ˈɦrudniː/
huba	/ˈɦuba/
Hubert	/ˈɦubɛrt/
hudba	/ˈɦudba/
hudobný	[ˈɦudobniː]
Hugo	/ˈɦuɡɔ/
huriska	[ˈɦuriska]
hus	/ɦus/
husi	/ˈɦusi/
husí	/ˈɦusiː/
husita	[ˈɦusita]
husle	/ˈɦuslɛ/
hustú	[ˈɦustuː]
hviezda	/ˈɦvi̯ɛzda/
hybný	/ˈɦibniː/
hydina	/ˈɦiɟina/
hymen	[ˈɦimen]
hystéria	/ˈɦistɛːria/
hľadať	/ˈɦʎadac/
ich	/Ëˆix/
Ida	/ˈida/
idea	/ˈidɛa/
idiot	/ˈidiɔt/
Ignác	/ˈiɡnaːt͡s/
ikra	/ˈikra/
íl	[iːl]
imágo	[ˈimaːɡo]
imel	[Ëˆimel]
imele	[Ëˆimele]
iná	[ˈinaː]
indium	/ˈindium/
infant	[ˈinfant]
hlave	[ˈɦlave]
denne	[ˈdene]
hora	[ˈɦora]
nosoch	[ˈnosox]
nosmi	[ˈnosmi]
koláčik	[ˈkolaːt͡ʃik]
koláčom	[ˈkolaːt͡ʃom]
koláču	[ˈkolaːt͡ʃu]
koláči	[ˈkolaːt͡ʃi]
koláča	[ˈkolaːt͡ʃa]
darovať	[ˈdarovac]
zaspať	[ˈzaspac]
na zdravie	[na zdravi̯e]
cestovať	[ˈt͡sestovac]
palec na nohe	[palet͡s na noɦe]
pieh	[pi̯ex]
pehy	[ˈpeɦi]
pehách	[ˈpeɦaːx]
pehám	[ˈpeɦaːm]
pohára	[ˈpoɦaːra]
informácia	/ˈinfɔrmaːt͡sia/
informovať	/ˈinfɔrmɔvac/
Ingrida	/ˈiŋɡrida/
inú	[ˈinuː]
iných	[ˈiniːx]
iným	[ˈiniːm]
inštrumentál	/ˈinʃtrumɛntaːɫ/
Irak	/ˈirak/
iránsky	/ˈiraːnski/
Íri	/ˈiːri/
irídium	/ˈiriːdium/
Íris	/ˈiːris/
Írsko	/ˈiːrskɔ/
iskierka	/ˈiski̯ɛrka/
-isko	/ˈiskɔ/
iskra	/ˈiskra/
islam	/ˈisɫam/
Islande	/ˈisɫanɟɛ/
istá	[ˈistaː]
istej	[ˈistej]
istí	[ˈistiː]
istou	[ˈistou]
istú	[ˈistuː]
ísť	/ˈiːsc/
Itália	[ˈitaːli̯a]
Ivan	/ˈivan/
Ivana	/ˈivana/
Iveta	/ˈivɛta/
Ivica	/ˈivit͡sa/
Ivona	/ˈivɔn/
Izabela	/ˈizabɛɫa/
Izák	/ˈizaːk/
izba	/ˈizba/
Izis	/ˈizis/
Izo	/ˈizɔ/
-ičitý	/it͡ʃitiː/
Iľja	/ˈiʎja/
-ište	/ˈiʃcɛ/
ja	/ˈja/
jabĺk	/ˈjabɫ̩ːk/
jablkách	/ˈjabɫ̩kaːx/
jablko	/jabɫ̩ko/
jabĺčko	/ˈjabɫ̩ːt͡ʃko/
jablčný	/ˈjabɫ̩t͡ʃniː/
jachta	/ˈjaxta/
jadrami	[ˈjadrami]
jadro	/ˈjadrɔ/
jahoda	/ˈjaɦɔda/
jahodami	/ˈjaɦɔdami/
jahňa	/ˈjaɦɲa/
jahňacina	[ˈjaɦɲat͡sina]
jak	/ˈjak/
Jakub	/ˈjakup/
jamôčka	/ˈjamu̯ɔt͡ʃka/
Ján	/ˈjaːn/
Jana	/ˈjana/
Janko	/ˈjaŋkɔ/
Jano	/ˈjanɔ/
Janov	/ˈjanɔu̯/
Jánov	/ˈjaː.nɔu̯/
jantár	/ˈjantaːr/
jantárový	/ˈjantaːrɔviː/
január	/ˈjanuaːr/
japončina	/ˈjapɔnt͡ʃina/
	
jarabica	/ˈjarabit͡sa/
jariem	[ˈjari̯em]
jarma	[ˈjarma]
jarme	[ˈjarme]
Jarmila	/ˈjarmiɫa/
jarmo	/ˈjar.mo/
jarmu	[ˈjarmu]
jarmulka	/ˈjarmuɫka/
Jaro	/ˈjarɔ/
jarok	/ˈja.rok/
Jarolím	/ˈjarɔliːm/
Jaromír	/ˈjarɔmiːr/
Jaroslav	/ˈjarɔsɫau̯/
Jaroslava	/ˈjarɔsɫava/
jaseň	/ˈjasɛɲ/
jaspis	[ˈjaspis]
jastrab	/ˈjastrap/
javor	/javor/
jazdec	/ˈjazɟɛt͡s/
jazera	/ˈjazɛra/
jazerá	/ˈjazɛraː/
jazyk	/ˈja.zik/
jazýček	/ˈja.ziː.t͡ʃɛk/
jačmeň	/ˈjat͡ʃmɛɲ/
jašterica	/ˈjaʃcɛrit͡sa/
jašterička	/ˈjaʃcɛrit͡ʃka/
je	[je]
jebačka	/ˈjɛbat͡ʃka/
jed	/ˈjɛt/
jedál	[ˈjedaːl]
jeden	[ˈjeden]
jedia	[ˈjedi̯a]
jediný	/ˈjeɟɪˌniː/
jedlá	[ˈjedlaː]
jedle	[ˈjedle]
jedlí	[ˈjedliː]
jedlom	[ˈjedlom]
jedna	/ˈjedna/
jednako	/jeːdnako/
jednej	/ˈjednej/
jednému	/ˈjedneːmu/
jedno	/ˈjedno/
jednoduchý	/ˈjɛdnɔduxiː/
jednom	/ˈjednom/
jedny	/ˈjedni/
jedných	/ˈjedniːx/
jedným	/ˈjedniːm/
jednými	/ˈjedniːmi/
jedový	/ˈjɛdɔviː/
jedľa	[ˈjedʎa]
jeho	/ˈjɛɦɔ/
jej	/ˈjɛj/
Jela	/ˈjɛɫa/
jeleň	/ˈjɛlɛɲ/
jelša	/ˈjɛɫʃa/
jem	[jem]
jeme	[ˈjeme]
jen	/jɛn/
Jeremiáš	/ˈjɛrɛmiaːʃ/
Jerguš	/ˈjɛrɡuʃ/
Jeruzalem	/ˈjɛruzalɛm/
jesenný	/ˈjɛsɛnniː/
jeseter	/ˈjɛsɛcɛr/
jeseň	/ˈjɛsɛɲ/
jesienka	/ˈjɛsi̯ɛŋka/
jestvovať	/ˈjɛstvɔvac/
jesť	/ˈjɛsc/
jete	[ˈjete]
ješ	[jeʃ]
Ježiš	/ˈjɛ.ʒiʃ/
jidiš	/ˈjidiʃ/
Jób	/ˈjɔːp/
jód	/ˈjoːt/
joga	/ˈjɔɡa/
jogurt	/ˈjɔɡurt/
Jolana	/ˈjɔɫana/
Jozef	/ˈjɔzɛf/
Jozefína	/ˈjɔzɛfiːna/
Jožo	/ˈjɔʒɔ/
JRD	/ˈjɛː ɛr dɛː/
ju	[ju]
Judita	/ˈjudita/
juh	/ˈjux/
júl	/ˈjuːɫ/
hlave	[ˈɦlave]
denne	[ˈdene]
hora	[ˈɦora]
nosoch	[ˈnosox]
nosmi	[ˈnosmi]
koláčik	[ˈkolaːt͡ʃik]
koláčom	[ˈkolaːt͡ʃom]
koláču	[ˈkolaːt͡ʃu]
koláči	[ˈkolaːt͡ʃi]
koláča	[ˈkolaːt͡ʃa]
darovať	[ˈdarovac]
zaspať	[ˈzaspac]
na zdravie	[na zdravi̯e]
cestovať	[ˈt͡sestovac]
palec na nohe	[palet͡s na noɦe]
pieh	[pi̯ex]
pehy	[ˈpeɦi]
pehách	[ˈpeɦaːx]
pehám	[ˈpeɦaːm]
pohára	[ˈpoɦaːra]
Július	/ˈjuːlius/
Julo	/ˈjuɫɔ/
jún	/ˈjuːn/
junák	/junaːk/
Juraj	/ˈjuraj/
Jurek	[ˈjurek]
Jurka	[ˈjurka]
Juro	/ˈjurɔ/
južný	/ˈjuʒniː/
-ka	/ka/
kabát	[ˈkabaːt]
kábel	/ˈkaːbɛɫ/
kaderník	/ˈkaɟɛrɲiːk/
kaderníčka	/ˈkaɟɛrɲiːt͡ʃka/
kadmium	/ˈkadmium/
káfir	[ˈkaːfir]
Káhira	/ˈkaːɦira/
kajak	/ˈkajak/
kalamár	/ˈkaɫamaːr/
kaleráb	/ˈkaleraːp/
kalifornium	/ˈkalifɔrnium/
kalypso	/ˈkalipsɔ/
Kambodža	/ˈkambɔd͡ʒa/
kameň	/ˈkamɛɲ/
Kamil	/ˈkamiɫ/
Kamila	/ˈkamiɫa/
Kanada	/ˈkanada/
kandidóza	/ˈkandidɔːza/
Kanton	/ˈkantɔn/
kapilára	/ˈkapiɫaːra/
kapusta	/ˈkapusta/
Kapverdy	/ˈkapvɛrdi/
Karina	/ˈkarina/
Karol	/ˈkarɔɫ/
karta	/karta/
kasíno	/ˈkasiːnɔ/
Kata	/ˈkata/
katapultami	/ˈkatapuɫtami/
katapulte	/ˈkatapuɫcɛ/
katapultoch	/ˈkatapuɫtɔx/
katapultom	/ˈkatapuɫtɔm/
katapultov	/ˈkatapuɫtɔu̯/
katapulty	/ˈkatapuɫti/
Katarína	/ˈkatariːna/
katedrála	/ˈkatedraːɫa/
Katovice	/ˈka.to.vi.t͡se/
káva	/ˈkaːva/
kaviareň	/ˈkavi̯arɛɲ/
kaviarnička	/ˈkavi̯arɲit͡ʃka/
Kazachstan	/ˈkazaxstan/
Kazateľ	/ˈkazacɛʎ/
Kazimír	/ˈkazimiːr/
Kača	/ˈkat͡ʃa/
Káčer Donald	/ˈkaːt͡ʃɛr dɔnaɫd/
kaňa	[ˈkaɲa]
kaša	/ˈkaʃa/
kaše	/ˈkaʃɛ/
kašeľ	/ˈkaʃɛʎ/
kašlať	/ˈkaʃɫac/
kaštieľ	/ˈkaʃci̯ɛʎ/
kašľať	/ˈkaʃlac/
kde	/ˈɡɟɛ/
kedže	[ˈked͡ʒe]
kel	/ˈkɛɫ/
ker	/kɛr/
Keňa	/ˈkɛɲa/
KGB	[ˈkaːɡeːbeː]
kila	/ˈkiɫa/
kile	/ˈkilɛ/
kilo	/ˈkiɫɔ/
kilogram	/ˈkiɫɔɡram/
kipa	/ˈkipa/
klamár	/ˈkɫamaːr/
klamstvo	/ˈkɫamstvɔ/
klas	/ˈkɫas/
klávesnica	/ˈkɫavɛsɲit͡sa/
kĺb	/kɫ̩ːb/
klišé	/ˈkliʃɛː/
klk	/ˈkɫ̩k/
klobása	/ˈkɫɔbaːsa/
klobúk	/ˈklɔbuːk/
klobúčik	/ˈkɫɔbuːt͡ʃik/
	
Kluž	/kluʃ/
kmene	/ˈkmɛɲɛ/
kmeňmi	/ˈkmɛɲmi/
kmeňoch	/ˈkmɛɲɔx/
kmeňom	/ˈkmɛɲɔm/
kmeňov	/ˈkmɛɲɔu̯/
kmeňu	/ˈkmɛɲu/
kmotor	/ˈkmɔtɔr/
kmotra	/ˈkmɔtra/
knieža	/ˈkɲi̯ɛʒa/
kníh	[kniːx]
kniha	/ˈkɲiɦa/
Kniha kráľov	/ˈkɲiɦa ˈkraːʎɔu̯/
Kniha kroník	/ˈkɲiɦa ˈkrɔɲiːk/
Kniha sudcov	/ˈkɲiɦa ˈsutt͡sɔu̯/
kníhkupec	/ˈkɲiːxkupɛt͡s/
kníhkupectvo	/ˈkɲiːxkupɛt͡stvɔ/
knižnica	/ˈkɲɪʒɲɪt͡sa/
knižočka	/ˈkɲiʒɔt͡ʃka/
knižôčka	/ˈkɲiʒu̯ɔt͡ʃka/
-ko	/kɔ/
kobalt	/ˈkɔbaɫt/
koberec	/ˈkɔbɛrɛt͡s/
kobier	/ˈkɔbi̯ɛr/
kobra	/ˈkɔbra/
kobrách	/ˈkɔbraːx/
kobrám	[ˈkobraːm]
kobrami	/ˈkɔbrami/
kobre	[ˈkobre]
kobrou	[ˈkobrou]
kobru	/ˈkɔbru/
kobry	/ˈkɔbri/
kobyla	/ˈkɔbiɫa/
Kobyla	/ˈkɔbiɫa/
kobza	/ˈkɔbza/
Kocian	[ˈkot͡si̯an]
kocka	/ˈkɔt͡ska/
kocôčka	/ˈkɔt͡su̯ɔt͡ʃka/
kocúr	/ˈkot͡suːr/
kohút	/ˈkɔɦuːt/
kohútik	/ˈkɔɦuːcik/
kokot	/ˈkɔkɔt/
kolár	[ˈkolaːr]
koláča	[ˈkolaːt͡ʃa]
koláče	[ˈkolaːt͡ʃe]
koláči	[ˈkolaːt͡ʃi]
koláčik	[ˈkolaːt͡ʃik]
koláčom	[ˈkolaːt͡ʃom]
koláčový	/ˈkɔɫaːt͡ʃɔviː/
koláču	[ˈkolaːt͡ʃu]
kolega	/ˈkɔlɛɡa/
koleno	/ˈkɔlɛnɔ/
Kolesár	[ˈkolesaːr]
koliba	/ˈkɔ.li.ba/
kolibrík	/ˈkɔlibriːk/
komunistický	/ˈkɔmuniscit͡skiː/
komunizmus	/ˈkɔmunizmus/
konár	/ˈkɔnaːr/
kongres	/ˈkɔŋɡrɛs/
koniec	/ˈkɔɲi̯ɛt͡s/
konšpiračná teória	/ˈkɔnʃpirat͡ʃnaː ˈtɛɔːria/
Konštantín	/ˈkɔnʃtantiːn/
kopija	/ˈkɔpija/
korbáč	[ˈkorbaːt͡ʃ]
kórejčina	/ˈkɔːrɛjt͡ʃina/
koreni	/ˈkɔrɛɲi/
koreň	/ˈkɔrɛɲ/
Koreň	/ˈkɔrɛɲ/
koreňa	/ˈkɔrɛɲa/
koreňmi	/ˈkɔrɛɲmi/
hlave	[ˈɦlave]
denne	[ˈdene]
hora	[ˈɦora]
nosoch	[ˈnosox]
nosmi	[ˈnosmi]
koláčik	[ˈkolaːt͡ʃik]
koláčom	[ˈkolaːt͡ʃom]
koláču	[ˈkolaːt͡ʃu]
koláči	[ˈkolaːt͡ʃi]
koláča	[ˈkolaːt͡ʃa]
darovať	[ˈdarovac]
zaspať	[ˈzaspac]
na zdravie	[na zdravi̯e]
cestovať	[ˈt͡sestovac]
palec na nohe	[palet͡s na noɦe]
pieh	[pi̯ex]
pehy	[ˈpeɦi]
pehách	[ˈpeɦaːx]
pehám	[ˈpeɦaːm]
pohára	[ˈpoɦaːra]
koreňoch	/ˈkɔrɛɲɔx/
koreňom	/ˈkɔrɛɲɔm/
koreňov	/ˈkɔrɛɲɔu̯/
koreňu	/ˈkɔrɛɲu/
kôrka	/ˈku̯or.ka/
Kornel	/ˈkɔrnɛɫ/
Kornélia	/ˈkɔrnɛːlia/
kôrovec	/ˈku̯ɔrɔvɛt͡s/
koruna	/ˈkoruna/
korytnačka	/ˈkɔritnat͡ʃka/
korčuľovať	/ˈkɔrt͡ʃuʎɔvac/
kosier	[ˈkosi̯er]
kôstkovina	/ˈku̯ɔstkɔvina/
kôstkoviny	/ˈku̯ɔstkɔvini/
Kostrová	/ˈkɔstrɔvaː/
kosť	/ˈkɔsc/
kováč	/ˈkɔvaːt͡ʃ/
Kováčová	/ˈkɔvaːt͡ʃɔvaː/
kovu	/ˈkɔvu/
koza	/ˈkɔza/
kozí	/ˈkoziː/
Kočiš	/ˈkɔt͡ʃiʃ/
Kočišová	/ˈkɔt͡ʃiʃɔvaː/
koľko	/ˈkɔʎkɔ/
Koľko je hodín?	/ˈkɔʎkɔ je ɦɔɟiːn/
kôň	[ku̯oɲ]
kôš	/ku̯oʃ/
košeľa	/ˈkɔʃɛʎa/
Košút	[ˈkoʃuːt]
kožušník	/ˈkɔʒuʃɲiːk/
krá	[kraː]
krádež	[ˈkraːdeʃ]
kraj	/kraj/
krajina	/krajina/
krajinách	/krajinaːx/
krajinu	/ˈkrajinu/
krajiny	/krajini/
krajmi	/krajmi/
krajoch	/krajox/
krajom	/krajom/
krajov	/krajou̯/
kraju	/kraju/
krajčír	/ˈkrajt͡ʃiːr/
Krakov	/ˈkrakou̯/
Krakova	[ˈkrakova]
králica	/ˈkralit͡sa/
králice	/ˈkraːlit͡sɛ/
králik	/ˈkraːʎik/
Králik	/ˈkraːʎik/
krása	/ˈkraːsa/
krásne	/ˈkraːsnɛ/
krásny	/ˈkraːsni/
krátky	/ˈkraːtki/
krava	/ˈkrava/
kravata	/ˈkravata/
kráčať	/ˈkraːt͡ʃac/
kráľ	/ˈkraːʎ/
Kráľ	[kraːʎ]
Kráľová	/ˈkraːʎɔvaː/
kráľovná	/ˈkraːʎɔvnaː/
kráľovstvo	/ˈkraːʎɔvstvɔ/
kŕdeľ	/ˈkr̩ːɟɛʎ/
kremácia	/ˈkrɛmaːt͡sia/
kremeň	/ˈkrɛmɛɲ/
kremík	/ˈkrɛmiːk/
krhla	/kr̩ɦla/
kristadelfián	/ˈkristadɛɫfiaːn/
Kristína	/ˈkristiːna/
Kristo	/ˈkristɔ/
krivec	[ˈkrivet͡s]
kríž	/ˈkriːʃ/
krk	/kr̩k/
Krk	/kr̩k/
krkavec	/ˈkr̩.ka.vɛt͡s/
krm	/kr̩m/
krokodíl	/ˈkrɔkɔdiːɫ/
krona	/ˈkrona/
króna	/ˈkroːna/
krst	/ˈkr̩st/
krstné meno	/ˈkr̩stnɛː mɛnɔ/
krt	/kr̩t/
krúžok	/ˈkruːʒɔk/
krv	/ˈkr̩w/
krvavnica	/ˈkr̩vau̯ɲit͡sa/
krvi	/ˈkr̩vi/
krvou	/ˈkr̩vɔu̯/
kŕč	/kr̩ːt͡ʃ/
kuba	/ˈkuba/
Kuba	/ˈkuba/
Kubánec	/ˈkubaːɲɛt͡s/
kuchyňa	/ˈkuxiɲa/
kukulienka	/ˈkukuli̯ɛŋka/
kukurica	/ˈkukurit͡sa/
kuli	/ˈkuli/
kulturistika	/ˈkuɫturistika/
kuna	/ˈkuna/
kunda	/ˈkun.da/
kupec	/ˈkupɛt͡s/
kúpeľ	/ˈkuːpɛʎ/
kupola	/ˈkupɔɫa/
kupovať	/ˈkupɔvac/
kura	/ˈkura/
kurence	/ˈkurɛnt͡sɛ/
kuru	[Ëˆkuru]
kurva	/ˈkurva/
kurča	/ˈkurt͡ʃa/
kus	/ˈkus/
kučeravý	/ˈkut͡ʃɛraviː/
kvapeľ	/ˈkvapɛʎ/
kvapôčka	/ˈkvapu̯ɔt͡ʃka/
kvark	/Ëˆkvark/
kvas	/ˈkvas/
kvasnice	/ˈkvasɲit͡sɛ/
kvet	/ˈkvɛt/
kvisling	/ˈkvisliŋɡ/
kýchať	/ˈkiːxac/
kýl	/kiːɫ/
kým	/ˈkiːm/
kyselina	/ˈkisɛlina/
kyselina sírová	/ˈkisɛlina ˈsiːrɔvaː/
kyslík	/ˈkisliːk/
kysličník	/ˈkislit͡ʃɲiːk/
kľúč	/kʎuːt͡ʃ/
kľúčik	/ˈkʎuːt͡ʃik/
ĺ	/ɫ̩ː/
Ĺ	/ɫ̩ː/
labutí	/ˈɫa.bu.ciː/
Laco	/ˈɫa.t͡so/
lama	/ˈɫama/
láma	/ˈɫaːma/
lamí	/ˈɫamiː/
lampa	/ˈɫam.pa/
landgróf	/ˈɫandɡrɔːf/
lángoš	/ˈɫaːŋɡɔʃ/
langue	/ɫaːŋɡ/
lano	/ˈɫanɔ/
lantán	/ˈɫantaːn/
láska	/ˈɫaːs.ka/
lastúrnik	/ˈɫastuːrɲik/
lastúrničiar	/ˈɫastuːrɲit͡ʃi̯ar/
latrína	/ˈɫatriːna/
hlave	[ˈɦlave]
denne	[ˈdene]
hora	[ˈɦora]
nosoch	[ˈnosox]
nosmi	[ˈnosmi]
koláčik	[ˈkolaːt͡ʃik]
koláčom	[ˈkolaːt͡ʃom]
koláču	[ˈkolaːt͡ʃu]
koláči	[ˈkolaːt͡ʃi]
koláča	[ˈkolaːt͡ʃa]
darovať	[ˈdarovac]
zaspať	[ˈzaspac]
na zdravie	[na zdravi̯e]
cestovať	[ˈt͡sestovac]
palec na nohe	[palet͡s na noɦe]
pieh	[pi̯ex]
pehy	[ˈpeɦi]
pehách	[ˈpeɦaːx]
pehám	[ˈpeɦaːm]
pohára	[ˈpoɦaːra]
Laura	/ˈɫau̯ra/
láva	/ɫaːva/
lawrencium	/ˈɫau̯rɛnt͡sium/
Lea	/ˈlɛa/
lebo	/ˈlɛbɔ/
lechický	/ˈlɛxit͡skiː/
Lei	/ˈlɛi/
lekár	/ˈlekaːr/
lekorica	/ˈlɛkɔrit͡sa/
Lenka	/ˈlɛŋka/
léno	/ˈlɛːnɔ/
lenže	/ˈlɛnʒɛ/
Leo	/ˈlɛɔ/
Leonard	/ˈlɛɔnard/
Leopold	/ˈlɛɔpɔld/
Leou	/ˈlɛɔu̯/
lepší	/ˈlɛpʃiː/
les	/ˈlɛs/
Lesana	/ˈlɛsana/
lesbický	/ˈlɛzbit͡skiː/
lesbička	/ˈlɛzbit͡ʃka/
lesť	/ˈlɛsc/
letieť	/ˈlɛci̯ɛc/
letisko	/ˈlɛciskɔ/
letište	/ˈlɛciʃcɛ/
letný	/ˈlɛtniː/
leto	/ˈlɛtɔ/
leu	/ˈlɛu̯/
lev	/lɛu̯/
leví	[ˈleviː]
Levoslav	/ˈlɛvɔsɫau̯/
lexikálny	/ˈlɛksikaːlni/
Ley	/ˈlɛi/
lečo	/ˈlɛt͡ʃɔ/
Liana	/ˈliana/
Libuša	/ˈlibuʃa/
líce	/ˈliːt͡sɛ/
Lichtenštajnsko	/ˈlixtɛnʃtajnskɔ/
lichva	[ˈlixva]
líder	/liːder/
lídra	/ˈliːdra/
lídrami	/ˈliːdrami/
lídri	/ˈliːdri/
lídroch	/ˈliːdrɔx/
lídrom	/ˈliːdrɔm/
lídrov	/ˈliːdrɔu̯/
lídrovi	/ˈliːdrɔvi/
lienka	/ˈli̯ɛŋka/
lietadlo	/ˈli̯ɛtadɫɔ/
lietať	/ˈli̯ɛtac/
lievik	/ˈli̯ɛvik/
lift	/ˈlift/
ligotať	/ˈliɡɔtac/
ligurček	/ˈliɡurt͡ʃɛk/
liknavý	/ˈliknaviː/
Linda	/ˈlinda/
Lipsko	/ˈlipskɔ/
list	/ˈlist/
lista	/Ëˆlista/
listami	/ˈlistami/
liste	/ˈliscɛ/
listoch	/ˈlistɔx/
listom	/ˈlistɔm/
listov	/ˈlistɔu̯/
listu	/ˈlistu/
Litava	/ˈlitava/
liter	/ˈlitɛr/
literatúra	/ˈliteratuːra/
lítium	/ˈliːtium/
litovčina	/ˈlitɔu̯t͡ʃina/
Litva	/ˈlitva/
Liva	/ˈliva/
livermorium	/ˈlivɛrmɔrium/
Lívia	/ˈliːvia/
lišiacky	/ˈliʃi̯at͡ski/
líška	/ˈliːʃka/
líštička	/ˈliʃcit͡ʃka/
Lodž	/ɫɔd͡ʒ/
logik	/ˈɫɔɡik/
logika	/ˈɫɔɡika/
lokomotíva	/ˈɫɔkɔmɔtiːva/
Londýn	/ˈɫɔndiːn/
lopata	/ˈɫɔpata/
lopta	/ˈɫɔpta/
losos	/ˈɫɔsɔs/
Lotyšsko	/ˈɫɔtiʃskɔ/
lotyština	/ˈɫɔtiʃcina/
lóve	/ˈɫɔːvɛ/
Lucia	/ˈɫut͡sia/
luhár	[ˈluɦaːr]
Lujza	/ˈɫujza/
luk	/ˈɫuk/
Luk	/ˈɫuk/
lúka	/ˈɫuːka/
lukostrelec	/ˈɫukɔstrɛlɛt͡s/
luna	/ˈluna/
lupina	[ˈlupina]
Luxembursko	/ˈɫuksɛmburskɔ/
Lýdia	/ˈliːdia/
lýra	/ˈliːra/
lýtko	/ˈliːtkɔ/
Macedónsko	/ˈmat͡sɛdɔːnskɔ/
Macek	[ˈmat͡sek]
machiavelizmus	/ˈmakiavɛlizmus/
machiavellizmus	/ˈmakiavɛlizmus/
machu	[ˈmaxu]
máj	/ˈmaːj/
maják	[ˈmajaːk]
mak	/ˈmak/
Malá Ázia	/ˈmaɫaː ˈaːzia/
Malachiáš	/ˈmaɫaxiaːʃ/
malajčina	/ˈmaɫajt͡ʃina/
malina	/ˈmalina/
malinový	/ˈmalinɔviː/
málo	[ˈmaːlo]
Malta	/ˈmaɫta/
malta	/ˈmaɫta/
Malte	[Ëˆmalte]
Maltou	[ˈmaltou]
Maltu	[ˈmaltu]
Malty	[ˈmalti]
maltčina	/ˈmaɫtt͡ʃina/
malvér	/ˈmaɫvɛːr/
Malvína	/ˈmaɫviːna/
malý	/ˈmaliː/
mám otázku	/ˈmaːm ˈɔtaːsku/
mama	/ˈmama/
manažment	/ˈmanaʒmɛnt/
mandarínka	/ˈmandariːŋka/
mandarínkovník	/ˈmandariːŋkɔvɲiːk/
mangán	/ˈmaŋɡaːn/
mantinel	/ˈmantinɛɫ/
mapa	/mapa/
mapa stránok	/ˈmapa ˈstraːnɔk/
Marcela	/ˈmart͡sɛɫa/
marec	/ˈmarɛt͡s/
Marek	/ˈmarɛk/
margaréta	/ˈmar.ɡa.re̞ː.ta/
Margaréta	/ˈmar.ɡa.re̞ː.ta/
margarétka	/ˈmar.ɡa.reːt.ka/
Margita	/ˈmarɡita/
marhuľa	/ˈmarɦuʎa/
Mária	/ˈmaː.ri.a/
Marián	/ˈmariaːn/
Marianna	/ˈmariana/
Marína	/ˈmariːna/
Mário	/ˈmaːriɔ/
márnica	/ˈmaːrɲit͡sa/
márnomyseľný	/ˈmaːrnɔmisɛʎniː/
Maroko	/ˈma.rɔ.kɔ/
Maroš	/ˈmarɔʃ/
Marta	/ˈmarta/
Martin	[Ëˆmartin]
Martina	/ˈmartina/
mäsiar	/ˈmɛsi̯ar/
maslo	/ˈmasɫɔ/
mäso	[ˈmæso]
mat	/mat/
mäta	/ˈmɛta/
máte	[ˈmaːte]
mäte	/ˈmɛcɛ/
Matej	/ˈmatɛj/
matematik	/ˈmatɛmatik/
matematika	/ˈmatɛmatika/
mater	/ˈmacɛr/
materinský	/ˈmacɛrinskiː/
materský	/ˈmacɛrskiː/
matica	/ˈmacit͡sa/
Matilda	/ˈmatiɫda/
matka	/ˈmatka/
matkin	/ˈmatkin/
Matúš	/ˈmatuːʃ/
Maximilián	/ˈmaksimiliaːn/
hlave	[ˈɦlave]
denne	[ˈdene]
hora	[ˈɦora]
nosoch	[ˈnosox]
nosmi	[ˈnosmi]
koláčik	[ˈkolaːt͡ʃik]
koláčom	[ˈkolaːt͡ʃom]
koláču	[ˈkolaːt͡ʃu]
koláči	[ˈkolaːt͡ʃi]
koláča	[ˈkolaːt͡ʃa]
darovať	[ˈdarovac]
zaspať	[ˈzaspac]
na zdravie	[na zdravi̯e]
cestovať	[ˈt͡sestovac]
palec na nohe	[palet͡s na noɦe]
pieh	[pi̯ex]
pehy	[ˈpeɦi]
pehách	[ˈpeɦaːx]
pehám	[ˈpeɦaːm]
pohára	[ˈpoɦaːra]
mačka	/ˈmat͡ʃka/
Maďar	/ˈmaɟar/
Maďarka	/ˈmaɟarka/
Maďarsko	/ˈmaɟarskɔ/
maďarčina	/ˈmaɟart͡ʃina/
maňuška	/ˈmaɲuʃka/
mašina	/ˈmaʃina/
mať	/ˈmac/
Maťo	/ˈmatɔ/
mech	/ˈmɛx/
med	/ˈmɛt/
Medard	/ˈmɛdard/
medovina	/ˈmɛdɔvina/
medvedica	/ˈmɛdvɛɟit͡sa/
medvedice	/ˈmɛd.vɛ.ɟi.t͡sɛ/
medveď	/ˈmɛdvɛc/
medzi	/ˈmɛd͡zi/
medzinárodný	/ˈmɛd͡zinaːrɔdniː/
meitnerium	/ˈmai̯tnɛrium/
Melánia	/ˈmɛɫaːnia/
mena	/ˈmɛna/
mendelevium	/ˈmɛndɛlɛvium/
mene	/ˈmɛɲɛ/
menej	/meɲej/
meniny	/ˈmɛɲini/
menu	/ˈmɛnu/
meny	/ˈmɛni/
menší	/ˈmɛnʃiː/
Merkúr	/ˈmɛrkuːr/
mesiac	/ˈmɛsi̯at͡s/
Mesiac	/ˈmɛsi̯at͡s/
mestečko	/ˈmɛscɛt͡ʃkɔ/
mesto	/ˈme̞s.to̞/
méta	[ˈmeːta]
metamorfóza	/ˈmɛtamɔrfɔːza/
meteorológia	/ˈmɛtɛɔrɔlɔːɡia/
metla	/ˈmɛtɫa/
metro	/ˈmɛtrɔ/
mexický	/ˈmɛksit͡skiː/
Mezopotámia	/ˈmɛzɔpɔtaːmia/
meč	/ˈmɛt͡ʃ/
meď	/ˈmɛc/
mešita	/ˈmɛʃita/
mias	/ˈmi̯as/
Michaela	[ˈmixaela]
Micheáš	/ˈmixɛaːʃ/
mien	/ˈmi̯ɛn/
miesto	/ˈmi̯ɛstɔ/
mikrosekunda	[Ëˆmikrosekunda]
mikroskop	/ˈmikrɔskɔp/
Mikuláš	/ˈmikuɫaːʃ/
Milada	/ˈmiɫada/
Milan	/ˈmiɫan/
Milena	/ˈmilɛna/
Milica	/ˈmilit͡sa/
Miloslav	/ˈmiɫɔsɫau̯/
Miloslava	/ˈmiɫɔsɫava/
Milota	/ˈmiɫɔta/
milujem ťa	/ˈmiɫujɛm ca/
milý	/ˈmiliː/
minca	/ˈmint͡sa/
Minsk	/ˈminsk/
minúta	/ˈminuːta/
Miriam	/Ëˆmiriam/
Miriama	/ˈmiriama/
Miro	/ˈmirɔ/
Miroslav	/ˈmirɔsɫau̯/
Miroslava	/ˈmirɔsɫava/
mitra	/ˈmitra/
Miškovec	/ˈmiʃkɔvɛt͡s/
mištička	/ˈmiʃcit͡ʃka/
mládež	/ˈmɫaːɟɛʃ/
mladý	/ˈmɫadiː/
mláďa	/ˈmɫaːɟa/
mláďatko	/ˈmɫaːɟatkɔ/
mledzivo	/ˈmlɛd͡zivɔ/
mliečko	/ˈmli̯ɛt͡ʃkɔ/
mlyn	/mlin/
mĺzť	/ˈmɫ̩ːsc/
mních	/ˈmɲiːx/
mnoho	/ˈmnɔɦɔ/
množina	/ˈmnɔʒina/
móda	/ˈmɔːda/
modlivka	/ˈmɔdliu̯ka/
modrý	/ˈmɔdriː/
moja	/ˈmɔja/
Mojmír	/ˈmɔjmiːr/
Mojžíš	/ˈmɔjʒiːʃ/
mokrí	[ˈmokriː]
molybdén	/ˈmɔlibdɛːn/
mops	/ˈmɔps/
Morava	/ˈmɔrava/
Morave	/ˈmɔravɛ/
moravský	/ˈmɔrau̯skiː/
more	/ˈmɔrɛ/
moriak	/ˈmɔri̯ak/
morča	/ˈmɔrt͡ʃa/
Moskva	/ˈmɔskva/
most	/ˈmɔst/
motorka	/ˈmɔtɔrka/
motýlí	/ˈmɔtiːʎiː/
mozog	/ˈmɔzɔk/
moľ	/ˈmɔʎ/
možno	/ˈmɔʒnɔ/
mravec	/ˈmravɛt͡s/
mráz	/ˈmraːs/
mŕtvola	/ˈmr̩ːtvɔɫa/
mŕtvy	/ˈmr̩ːt.vɪ/
mŕľ	/mr̩ːʎ/
múch	/muːx/
mucha	/ˈmuxa/
Mucha	[ˈmuxa]
muche	/ˈmuxɛ/
muchotrávka	/ˈmuxɔtraːu̯ka/
mudrc	/ˈmudr̩t͡s/
múdri	[ˈmuːdri]
múdry	/ˈmuːdri/
Múdry	/ˈmuːdri/
musieť	/ˈmusi̯ɛc/
muž	/muʃ/
muži	/ˈmʊʒɪ/
mužský	/ˈmuʃskiː/
my	/Ëˆmi/
mydlo	/ˈmidɫɔ/
myslieť	/ˈmisli̯ɛc/
mýto	/ˈmiːtɔ/
myš	/ˈmiʃ/
myší	/ˈmiʃiː/
myšiu	/ˈmiʃi̯u/
myšlienka	/ˈmiʃli̯ɛŋka/
mzda	/mzda/
mňa	[mɲa]
na	/ˈna/
na zdravie	[na zdravi̯e]
nacionalista	/ˈnat͡siɔnalista/
nacionalistický	/ˈnat͡siɔnalistit͡skiː/
nacionalistka	/ˈnat͡siɔnalistka/
nacionalizmus	/ˈnat͡siɔnalizmus/
nacista	/ˈnat͡sista/
nacistický	/ˈnat͡sistit͡skiː/
nactiutŕhač	/ˈna.t͡sci.u.tr̩ː.ɦat͡ʃ/
nádcha	/ˈnaːtxa/
nádherný	/ˈnaːdɦɛrniː/
Nadlak	/ˈnadɫak/
nádraží	/ˈnaːdraʒiː/
nádražia	/ˈnaːdraʒi̯a/
nádražiach	/ˈnaːdraʒi̯ax/
nádražiam	/ˈnaːdraʒi̯am/
nádražiami	/ˈnaːdraʒi̯ami/
hlave	[ˈɦlave]
denne	[ˈdene]
hora	[ˈɦora]
nosoch	[ˈnosox]
nosmi	[ˈnosmi]
koláčik	[ˈkolaːt͡ʃik]
koláčom	[ˈkolaːt͡ʃom]
koláču	[ˈkolaːt͡ʃu]
koláči	[ˈkolaːt͡ʃi]
koláča	[ˈkolaːt͡ʃa]
darovať	[ˈdarovac]
zaspať	[ˈzaspac]
na zdravie	[na zdravi̯e]
cestovať	[ˈt͡sestovac]
palec na nohe	[palet͡s na noɦe]
pieh	[pi̯ex]
pehy	[ˈpeɦi]
pehách	[ˈpeɦaːx]
pehám	[ˈpeɦaːm]
pohára	[ˈpoɦaːra]
nádražie	/ˈnaːdraʒi̯ɛ/
nádražím	/ˈnaːdraʒiːm/
nádražiu	/ˈnaːdraʒi̯u/
nadšený	/ˈnat.ʃeˌniː/
nahí	/ˈnaɦiː/
nahú	[ˈnaɦuː]
Nahum	/ˈnaɦum/
najmenej	/najmeɲej/
najnižší	/ˈnajɲiʃʃiː/
nájsť	/ˈnaːjsc/
najužší	/ˈnajuʃʃiː/
najviac	/najvjat͡s/
najvyšší	/ˈnajviʃʃiː/
námestíčko	/ˈnaːmɛsciːt͡ʃkɔ/
naozaj	/ˈnaɔzaj/
napokon	/napokon/
náprotivok	[ˈnaːprotivok]
naraňajkovať	/ˈnaraɲajkɔvac/
nárečie	/ˈnaːrɛt͡ʃi̯ɛ/
narkomanka	/ˈnarkɔmaŋka/
narodeniny	/ˈnarɔɟɛɲini/
národný	/ˈnaːrɔdniː/
nás	/naːs/
Nataša	/ˈnataʃa/
náter	/ˈnaːcɛr/
Nauru	/ˈnauru/
návrh	/ˈnaːvr̩x/
návrhy	/ˈnaːvr̩ɦi/
nazdar	/ˈnazdar/
názov	/ˈnaːzɔu̯/
naďalej	/ˈnaɟalɛj/
nebo	/ˈɲɛbɔ/
nebohý	/ˈɲɛbɔɦiː/
necht	/ˈɲɛxt/
nedeľa	/ˈɲeɟelʲa/
negližé	/ˈnɛɡliʒɛː/
Nehemiáš	/ˈɲɛɦɛmiaːʃ/
Nemec	/ˈɲɛmɛt͡s/
Nemecko	/ˈɲɛmɛt͡skɔ/
nemecký	/ˈɲɛmɛt͡skiː/
nemecký ovčiak	[nemet͡skiː ovt͡ʃi̯ak]
nemý	/ˈɲɛmiː/
neodým	/ˈnɛɔdiːm/
nepárnokopytník	/ˈɲɛpaːrnɔkɔpitɲiːk/
nepárny	/ˈɲɛpaːrni/
nepravda	[ˈnepravda]
Nero	/ˈnɛrɔ/
nerozumiem	/ˈɲɛrɔzumi̯ɛm/
nesčíselný	/ˈɲɛst͡ʃiːsɛlniː/
netopier	/ˈɲɛtɔpi̯ɛr/
nevädza	/ˈɲɛvɛd͡za/
New York	/ɲuː jɔrk/
nezmysel	/ˈɲɛzmisɛɫ/
nielen	/ˈɲi̯ɛlɛn/
nijaký	/ˈɲijakiː/
-ník	/ɲiːk/
Nikola	/ˈnikɔɫa/
Nina	/ˈɲina/
niób	/ˈniɔːp/
Níreďháza	/ˈɲiːrɛɟɦaːza/
nízky	/ˈɲiːski/
nič	/ˈɲit͡ʃ/
nížina	/ˈɲiːʒina/
nižší	/ˈɲiʃʃiː/
nobelium	/ˈnɔbɛlium/
noc	/ˈnɔt͡s/
Noe	/ˈnɔɛ/
nôh	/nu̯ox/
noha	/ˈnɔɦa/
nohách	[ˈnoɦaːx]
nohám	[ˈnoɦaːm]
nohami	[ˈnoɦami]
nohavica	/ˈnɔɦavit͡sa/
nohavice	/ˈnɔɦavit͡sɛ/
nohou	[ˈnoɦou]
nohu	[ˈnoɦu]
nohy	[ˈnoɦi]
nominatív	/ˈnɔminatiːu̯/
Nora	/ˈnɔra/
Norbert	/ˈnɔrbɛrt/
Nórsko	/ˈnɔːrskɔ/
nórsky	/ˈnɔːrski/
nórčina	/ˈnɔːrt͡ʃina/
nos	[nos]
nosmi	[ˈnosmi]
nosoch	[ˈnosox]
Novak	/ˈnɔvak/
Novák	/ˈnɔvaːk/
nováčik	/ˈnɔvaːt͡ʃik/
nové	/ˈnɔvɛː/
Nové Mexiko	/ˈnɔvɛː mɛksikɔ/
november	/ˈnɔvɛmbɛr/
noviny	/ˈnɔvini/
nový	/ˈnɔviː/
Nový Južný Wales	/ˈnɔviː juʒniː vɛjlz/
Nový Zéland	/ˈnɔviː zɛːɫand/
nočný	/ˈnɔt͡ʃniː/
nôž	/nu̯oʃ/
nôžka	/ˈnu̯ɔʃka/
obdĺžnik	/ˈɔbdɫ̩ːʒɲik/
objektový jazyk	/ˈɔbjɛktɔviː jazik/
oblasť	/ˈɔbɫasc/
obláčik	/ˈɔbɫaːt͡ʃik/
obojživelník	[ˈobojʒivelniːk]
obor	/ˈɔbɔr/
obraz	/ˈɔbras/
obrus	/ˈɔbrus/
obyvateľ	/ˈɔbivacɛʎ/
občiansky preukaz	/ˈɔpt͡ʃi̯anski prɛu̯kas/
obťažný	/ˈɔpcaʒniː/
oca	[ˈot͡sa]
ocami	[ˈot͡sami]
oceľ	[ˈot͡seʎ]
ococh	[ˈot͡sox]
ocom	[ˈot͡som]
ocov	[ˈot͡sof]
ocovi	[ˈot͡sovi]
od	/ˈɔd/
óda	/ˈɔːda/
odborníčka	/ˈɔdbɔrɲiːt͡ʃka/
odhodlaný	/ˈodɦodlaˌniː/
odo	/ˈɔdɔ/
odpoludnie	/ˈɔtpɔɫudɲi̯ɛ/
odpor	[ˈodpor]
oheň	/ˈɔɦɛɲ/
ohovárať	/ˈɔɦɔvaːrac/
ohúriť	/ˈɔɦuːric/
ohňostroj	/ˈɔɦɲɔstrɔj/
oje	/ˈɔjɛ/
ôk	[u̯ok]
oka	[Ëˆoka]
oká	[ˈokaː]
okabátiť	/ˈɔkabaːcic/
okách	[ˈokaːx]
okám	[ˈokaːm]
okami	[ˈokami]
okna	/ˈɔkna/
okná	/ˈɔknaː/
okno	/ˈɔknɔ/
oko	/ˈɔkɔ/
okolo	/ˈɔkɔɫɔ/
okom	[ˈokom]
okrem	/ˈɔkrɛm/
október	/ˈɔktɔːbɛr/
oku	[Ëˆoku]
okuliare	/ˈɔkuʎi̯arɛ/
hlave	[ˈɦlave]
denne	[ˈdene]
hora	[ˈɦora]
nosoch	[ˈnosox]
nosmi	[ˈnosmi]
koláčik	[ˈkolaːt͡ʃik]
koláčom	[ˈkolaːt͡ʃom]
koláču	[ˈkolaːt͡ʃu]
koláči	[ˈkolaːt͡ʃi]
koláča	[ˈkolaːt͡ʃa]
darovať	[ˈdarovac]
zaspať	[ˈzaspac]
na zdravie	[na zdravi̯e]
cestovať	[ˈt͡sestovac]
palec na nohe	[palet͡s na noɦe]
pieh	[pi̯ex]
pehy	[ˈpeɦi]
pehách	[ˈpeɦaːx]
pehám	[ˈpeɦaːm]
pohára	[ˈpoɦaːra]
okuliarnik	/ˈɔkuʎi̯arɲik/
-ola	/ɔɫa/
Oldrich	/ˈɔɫdrix/
Oleg	/ˈɔlɛk/
oligarchia	/ˈɔliɡarxia/
olív	/ˈɔliːu̯/
oliva	/oliva/
olivách	/ˈɔlivaːx/
olivám	/ˈɔlivaːm/
olivami	/ˈɔlivami/
olive	/ˈɔlivɛ/
Oliver	/ˈɔlivɛr/
Olívia	/ˈɔliːvia/
olivou	/ˈɔlivɔu̯/
olivu	/ˈɔlivu/
olivy	/ˈɔlivi/
Olomouc	/ˈɔɫɔmɔu̯t͡s/
olomoucký	/olomou̯t͡skiː/
olovo	/ˈɔɫɔvɔ/
olovrant	/ˈɔɫɔvrant/
Olympia	/ˈɔlimpia/
olympiáda	/ˈɔlimpiaːda/
oman	[ˈoman]
omanom	[ˈomanom]
on	/ɔn/
Ondrejko	[ˈondrejko]
Ondrusek	[ˈondrusek]
Ondrušek	[ˈondruʃek]
Ondruška	[ˈondruʃka]
Ondruško	[ˈondruʃko]
oni	/ˈɔɲi/
ony	/ˈɔni/
opát	/ˈɔpaːt/
opilec	/ˈɔpilɛt͡s/
opitý	/ˈɔpitiː/
opustiť	/ˈɔpuscic/
Oravec	[ˈoravet͡s]
orgazmu	/ˈɔrɡazmu/
orgazmus	/ˈɔrɡazmus/
orlami	[ˈorlami]
orlej	/ˈɔrʎɛj/
orlí	/ˈɔrliː/
orloch	[ˈorlox]
orlom	[ˈorlom]
ornitológia	/ˈɔrnitɔɫɔːɡia/
ortuť	[ˈortuc]
os	/ɔs/
ôs	[u̯os]
osem	/ˈɔsɛm/
osemnásť	/ˈɔsɛmnaːsc/
Oskár	/ˈɔskaːr/
osla	/ɔsɫa/
oslobodiť	/ˈɔsɫɔbɔɟic/
osmium	/ˈɔsmium/
ôsmy	/ˈu̯os.mi/
osôb	/ˈɔ.su̯op/
osoba	/ˈɔsɔba/
osoby	/ˈɔ.sɔ.bi/
	
ostriež	/ˈɔstri̯ɛʃ/
Ostrihom	/ˈɔstriɦɔm/
ostrov	/ˈostrou̯/
osľa	/ˈɔsʎa/
-osť	/ɔsc/
otázka	/ˈɔtaːska/
otázočka	/ˈɔtaːzɔt͡ʃka/
otcov	/ˈɔtt͡sɔu̯/
otcovský	/ˈɔtt͡sɔu̯skiː/
otec	/ˈɔcɛt͡s/
Otília	/ˈɔtiːlia/
Oto	/ˈɔtɔ/
otráviť	/ˈɔtraːvic/
otrok	/ˈɔtrɔk/
-ovať	/ɔvac/
ovca	/ˈɔu̯t͡sa/
ovocie	/ˈɔvɔt͡si̯ɛ/
-ový	/ɔviː/
ovčí	/ˈɔu̯t͡ʃiː/
ozajstný	/ˈɔzajstniː/
Ozeáš	/ˈɔzɛaːʃ/
očami	[ˈot͡ʃami]
Očenáš	[ˈot͡ʃenaːʃ]
oči	[ˈot͡ʃi]
očí	[ˈot͡ʃiː]
očko	/ˈɔt͡ʃkɔ/
očú	[ˈot͡ʃuː]
Oľga	/ˈɔʎɡa/
ožran	/ˈɔʒran/
pakľúč	[ˈpakʎuːt͡ʃ]
palác	/ˈpaɫaːt͡s/
palacinka	/ˈpalatsiŋka/
paládium	/ˈpaɫaːdium/
palec na nohe	[palet͡s na noɦe]
pálenka	/ˈpaːlɛŋka/
palina	[ˈpalina]
páliť	/ˈpaːlic/
Palka	[ˈpalka]
Palko	[ˈpalko]
pamäť	/ˈpamɛc/
pán	/ˈpaːn/
pána	[ˈpaːna]
pane	/ˈpaɲɛ/
panenská blana	/ˈpaɲɛnskaː bɫana/
panenský	/ˈpaɲɛnskiː/
pani	/ˈpaɲi/
panic	/ˈpaɲit͡s/
panien	[ˈpani̯en]
Pankrác	/ˈpaŋkraːt͡s/
panna	/ˈpan.na/
panne	[ˈpane]
panpsychizmus	/ˈpanpsixizmus/
panteizmus	/ˈpanteizmus/
papagáj	[ˈpapaɡaːj]
papraď	/ˈpaprac/
paprika	/ˈpaprika/
paradajka	/ˈparadajka/
Paris	/paris/
Paríž	/ˈpariːʃ/
párnokopytník	/ˈpaːrnɔkɔpitɲiːk/
párny	/ˈpaːrni/
parochňa	/ˈparɔxɲa/
parole	/ˈparɔɫ/
partnerstvo	[ˈpartnerstvo]
pásomnica	/ˈpaːsɔmɲit͡sa/
pasta	[ˈpasta]
pastier	/ˈpasci̯ɛr/
pat	/ˈpat/
pätica	/ˈpɛcit͡sa/
pätnásť	/ˈpɛtnaːsc/
Patrik	/Ëˆpatrik/
patriť	/ˈpatric/
Paulína	/ˈpau̯liːna/
páv	/ˈpaːu̯/
paveda	[ˈpaveda]
páví	/ˈpaːviː/
Pavol	/ˈpavɔɫ/
pavúk	/ˈpavuːk/
pavúčí	/ˈpavuːt͡ʃiː/
pazucha	/ˈpazuxa/
Paľo	/ˈpaʎɔ/
Pašek	[ˈpaʃek]
Paška	[ˈpaʃka]
Paško	[ˈpaʃko]
päť	/ˈpɛc/
pažerák	/ˈpaʒɛraːk/
pec	/ˈpɛt͡s/
pedagogika	/ˈpɛdaɡɔɡika/
pederastia	/ˈpɛdɛrastia/
peha	/ˈpɛɦa/
pehách	[ˈpeɦaːx]
pehám	[ˈpeɦaːm]
pehami	[ˈpeɦami]
pehe	/ˈpɛɦɛ/
pehy	[ˈpeɦi]
peklo	/ˈpɛkɫɔ/
pekná	[ˈpeknaː]
pekné	[ˈpekneː]
	
pena	/ˈpɛna/
peniaze	/ˈpɛɲi̯azɛ/
perga	[ˈperɡa]
perla	/ˈpɛrɫa/
Perla	/ˈpɛrɫa/
Persefona	/ˈpɛrsɛfɔna/
perspektíva	/ˈpɛrspɛktiːva/
Peržan	/ˈpɛrʒan/
pes	/ˈpɛs/
pestrý	/ˈpɛstriː/
Peter	/ˈpɛtɛr/
Petra	/ˈpɛtra/
hlave	[ˈɦlave]
denne	[ˈdene]
hora	[ˈɦora]
nosoch	[ˈnosox]
nosmi	[ˈnosmi]
koláčik	[ˈkolaːt͡ʃik]
koláčom	[ˈkolaːt͡ʃom]
koláču	[ˈkolaːt͡ʃu]
koláči	[ˈkolaːt͡ʃi]
koláča	[ˈkolaːt͡ʃa]
darovať	[ˈdarovac]
zaspať	[ˈzaspac]
na zdravie	[na zdravi̯e]
cestovať	[ˈt͡sestovac]
palec na nohe	[palet͡s na noɦe]
pieh	[pi̯ex]
pehy	[ˈpeɦi]
pehách	[ˈpeɦaːx]
pehám	[ˈpeɦaːm]
pohára	[ˈpoɦaːra]
Petronela	/ˈpɛtrɔnɛɫa/
pečeň	/ˈpɛtʃɛɲ/
pečiatka	/ˈpɛt͡ʃi̯atka/
peň	/ˈpɛɲ/
pešiak	/ˈpɛʃi̯ak/
Peťo	/ˈpɛcɔ/
piano	/ˈpianɔ/
piat	[pi̯at]
piata	[ˈpi̯ata]
piate	[ˈpi̯ate]
piatej	[ˈpi̯atej]
piatemu	[ˈpi̯atemu]
piati	[ˈpi̯ati]
piatok	/ˈpi̯atok/
piatu	[ˈpi̯atu]
piaty	/ˈpi̯ati/
pieh	[pi̯ex]
piepor	/ˈpi̯ɛpɔr/
pieseň	/pi̯eseɲ/
Pieseň piesní	/ˈpi̯ɛsɛɲ pi̯ɛsɲiː/
pieskovisko	/ˈpi̯ɛskɔviskɔ/
piest	[pi̯est]
Piešťany	/ˈpi̯ɛʃcani/
pijan	/ˈpijan/
píla	[ˈpiːla]
pilier	/ˈpili̯ɛr/
pipík	/ˈpipiːk/
písať	/ˈpiːsac/
písmeno	/ˈpiːsmɛnɔ/
pitjantjatjara	/ˈpicancacara/
pivá	/ˈpivaː/
pivo	/pivo/
pizda	/ˈpizda/
pizza	/ˈpi.t͡sa/
píč	[piːt͡ʃ]
piča	[ˈpit͡ʃa]
pičami	[ˈpit͡ʃami]
piče	[ˈpit͡ʃe]
piči	[ˈpit͡ʃi]
piču	[ˈpit͡ʃu]
plamenček	/ˈpɫamɛnt͡ʃɛk/
plamienok	/ˈpɫami̯ɛnɔk/
planéta	/ˈpɫanɛːta/
plat	/ˈpɫat/
platiť	/ˈpɫacic/
platom	[ˈplatom]
plávať	/ˈpɫaːvac/
pláž	/ˈpɫaːʃ/
plch	/ˈpɫ̩x/
plece	/ˈplet͡se/
plecniak	/ˈplɛt͡sɲi̯ak/
plný	/pl̩niː/
plsť	/ˈpɫ̩sc/
plukovník	/ˈpɫukɔvɲiːk/
plyn	[plin]
Plzeň	/ˈpɫ̩zɛɲ/
plť	/pɫ̩c/
pneumatika	/ˈpnɛ.u.ma.ti.ka/
pochodovať	/ˈpɔxɔdɔvac/
pod	/ˈpɔt/
podmet	/ˈpɔdmɛt/
podmienka	/ˈpɔdmi̯ɛŋka/
podnikateľ	/ˈpɔdɲikacɛʎ/
podpazušie	/ˈpɔtpazuʃi̯ɛ/
podprsenka	/ˈpɔtpr̩sɛŋka/
podstatné meno	/ˈpɔtstatnɛː mɛnɔ/
pohár	/ˈpɔɦaːr/
pohára	[ˈpoɦaːra]
poháre	[ˈpoɦaːre]
pohlavie	/ˈpɔɦɫavi̯ɛ/
pohľad	/ˈpɔɦʎat/
pokoj	/ˈpɔkɔj/
pokračovať	/ˈpɔkrat͡ʃɔvac/
pokrievka	/ˈpɔkri̯ɛu̯ka/
pokým	/ˈpɔkiːm/
polabčina	/ˈpɔɫapt͡ʃina/
policajt	/ˈpɔlit͡sajt/
police	/ˈpɔlit͡sɛ/
polícia	/ˈpɔliːt͡sia/
polievka	/ˈpɔli̯ɛu̯ka/
polievočka	/ˈpɔli̯ɛvɔt͡ʃka/
politik	/ˈpɔlitik/
politika	/ˈpɔlitika/
polnoc	[ˈpolnot͡s]
polónium	/ˈpɔɫɔːnium/
poloostrov	/ˈpɔɫɔɔstrɔu̯/
polostrov	/ˈpɔɫɔstrɔu̯/
polynok	[ˈpolinok]
pomalý	/ˈpɔmaliː/
pomaranč	/ˈpɔmarant͡ʃ/
pomoc	/ˈpɔmɔt͡s/
pomocné sloveso	/ˈpɔmɔt͡snɛː sɫɔvɛsɔ/
pomôcť	/ˈpɔmu̯ɔt͡sc/
pomorník	/ˈpɔmɔrɲiːk/
ponáhľať	/ˈpɔnaːɦʎac/
pondelok	/ˈpɔnɟɛɫɔk/
ponorka	/ˈpɔnɔrka/
pontifex	/ˈpo̞ntife̞ks/
ponuka	/ˈpɔnuka/
pop	/pop/
popol	/ˈpɔpɔɫ/
popoludnie	/ˈpɔpɔɫudɲi̯ɛ/
pornografia	/ˈpɔrnɔɡrafia/
pornografický	/ˈpɔrnɔɡrafit͡skiː/
Portugalsko	/ˈpɔrtuɡaɫskɔ/
portugalčina	/ˈpɔrtuɡaɫt͡ʃina/
posledný	/ˈpɔslɛdniː/
posol	[ˈposol]
posteľ	/ˈpɔscɛʎ/
potok	/ˈpɔtɔk/
potôčik	/ˈpɔtu̯ɔt͡ʃik/
potravina	/ˈpɔtravina/
potrebný	/ˈpɔtrɛbniː/
potrebovať	/ˈpɔtrɛbɔvac/
používateľ	/ˈpɔuʒiːvacɛʎ/
povaha	/ˈpɔvaɦa/
povedať	/ˈpɔvɛdac/
pôvod	/ˈpu̯ɔvɔt/
povolenie	[ˈpovoleni̯e]
povraz	/ˈpɔvras/
Pozdech	[ˈpozdex]
pozdĺž	/ˈpɔ.zdɫ̩ːʃ/
Poznaň	/ˈpɔz.naɲ/
poznať	/ˈpɔznac/
počas	/ˈpɔt͡ʃas/
počasie	/ˈpɔt͡ʃasi̯ɛ/
počet	/ˈpɔt͡ʃɛt/
počty	/ˈpɔt͡ʃti/
počúvať	/ˈpɔt͡ʃuːvac/
počuť	/ˈpɔt͡ʃuc/
Poľsko	/ˈpɔʎskɔ/
poľština	/ˈpɔʎʃcina/
pošta	/ˈpoʃta/
požiar	/ˈpɔʒi̯ar/
požičať	/ˈpɔʒit͡ʃac/
pôžička	/ˈpu̯ɔʒit͡ʃka/
prababa	[ˈprababa]
práca	/ˈpraːt͡sa/
pracháč	/ˈpraxaːt͡ʃ/
Praha	/ˈpraɦa/
prajazyk	/ˈprajazik/
prak	[prak]
prakmi	[ˈprakmi]
prakoch	[ˈprakox]
prakov	[ˈprakof]
prasa	/ˈprasa/
pravda	/ˈprau̯da/
pravdách	/pravdaːx/
pravdám	/pravdaːm/
pravdu	/pravdu/
pravdy	/pravdi/
práve	/ˈpraːvɛ/
Pravoslav	/ˈpravɔsɫau̯/
pravý	/ˈpraviː/
prázdniny	/ˈpraːzdɲini/
prázdny	/ˈpraːzdni/
prazeodým	/ˈpra.zɛ.ɔ.diːm/
Pražan	/ˈpraʒan/
pražský	/ˈpraʃskiː/
prd	/ˈpr̩t/
prdieť	/ˈpr̩ɟi̯ɛc/
predať	/ˈprɛdac/
predložka	/ˈprɛdɫɔʃka/
predmestie	/ˈprɛdmɛsci̯ɛ/
predsa	/ˈprɛtsa/
predseda	/ˈprɛtsɛda/
premávka	/ˈprɛmaːu̯ka/
pretekár	/ˈprɛcɛkaːr/
pretekať	/ˈprɛcɛkac/
preteky	/ˈprɛcɛki/
pretože	/ˈprɛtɔʒɛ/
preukaz	/ˈpre.u.kaz/
preukázať	/ˈprɛukaːzac/
hlave	[ˈɦlave]
denne	[ˈdene]
hora	[ˈɦora]
nosoch	[ˈnosox]
nosmi	[ˈnosmi]
koláčik	[ˈkolaːt͡ʃik]
koláčom	[ˈkolaːt͡ʃom]
koláču	[ˈkolaːt͡ʃu]
koláči	[ˈkolaːt͡ʃi]
koláča	[ˈkolaːt͡ʃa]
darovať	[ˈdarovac]
zaspať	[ˈzaspac]
na zdravie	[na zdravi̯e]
cestovať	[ˈt͡sestovac]
palec na nohe	[palet͡s na noɦe]
pieh	[pi̯ex]
pehy	[ˈpeɦi]
pehách	[ˈpeɦaːx]
pehám	[ˈpeɦaːm]
pohára	[ˈpoɦaːra]
prezident	/ˈprɛzidɛnt/
prezývka	/ˈprɛziːu̯ka/
preč	/ˈprɛt͡ʃ/
prečo	/ˈpretʃo/
Prešov	/ˈprɛʃɔu̯/
Prešporok	/ˈprɛʃpɔrɔk/
prežúvavec	/ˈprɛʒuːvavɛt͡s/
pŕhľava	/ˈpr̩ːɦʎava/
pŕhľaviar	[ˈpr̩ːɦʎavi̯ar]
pŕhľavka	/ˈpr̩ːɦʎau̯ka/
priateľ	/ˈpri̯acɛʎ/
priateľka	/ˈpri̯acɛʎka/
príchod	/ˈpriːxɔt/
prídavné meno	/ˈpriːdavnɛː mɛnɔ/
priehlavok	/ˈpri̯ɛɦɫavɔk/
priestor	/ˈpri̯ɛstɔr/
Prievidza	[ˈpri̯evid͡za]
priezvisko	/ˈpri̯ɛzviskɔ/
priečinok	/ˈpri̯ɛt͡ʃinɔk/
príklad	/ˈpriːkɫat/
prilba	[ˈprilba]
prímerie	/ˈpriːmɛri̯ɛ/
primusieť	/ˈprimusi̯ɛc/
princ	/ˈprint͡s/
princezná	/ˈprint͡sɛznaː/
prinútiť	/ˈprinuːcic/
prípad	/ˈpriːpat/
príroda	/ˈpriːrɔda/
Príslovia	/ˈpriːsɫɔvi̯a/
príslovie	/ˈpriːsɫɔvi̯ɛ/
príslovka	/ˈpriːsɫɔu̯ka/
prísudok	/ˈpriːsudɔk/
prísť	/ˈpriːsc/
privlastňovacie prídavné meno	/ˈprivɫastɲɔvat͡si̯ɛ ˈpriːdavnɛː ˈmɛnɔ/
program	/ˈprɔɡram/
Prokop	/ˈprɔkɔp/
prométium	/ˈprɔmɛːtium/
prosím	[ˈprosiːm]
prostredie	/ˈprɔstrɛɟi̯ɛ/
protaktínium	/ˈprɔtaktiːnium/
proti gustu žiaden dišputát	/ˈprɔci ɡustu ʒi̯aɟɛn diʃputaːt/
protirečiť	/ˈprɔcirɛt͡ʃic/
protivný	/ˈprɔcivniː/
protojazyk	/ˈprɔtɔjazik/
próza	/ˈpro̞ːza/
prozódia	/ˈprɔzɔːdia/
pŕs	/ˈpr̩ːs/
	
prsník	/ˈpr̩sɲiːk/
prst	/pr̩st/
prsteň	/ˈpr̩scɛɲ/
prsť	/pr̩sc/
prúd	[pruːt]
prv	/pr̩w/
prvé meno	/ˈpr̩vɛː ˈmɛnɔ/
prvosienka	/ˈpr̩vɔsi̯ɛŋka/
prvočíslo	/ˈpr̩vɔt͡ʃiːsɫɔ/
prvý	/ˈpr̩viː/
pršať	/ˈpr̩ʃac/
psi	[psi]
psí	/ˈpsiː/
psica	/ˈpsit͡sa/
psiemu	/ˈpsi̯ɛmu/
psoch	[psox]
psov	[psof]
psychológia	/ˈpsixɔɫɔːɡia/
puma	/ˈpu.ma/
púpava	/ˈpuːpava/
puška	/puʃka/
púšť	/ˈpuːʃc/
pýcha	/ˈpiːxa/
pytón	/ˈpitɔːn/
pyžamo	/ˈpiʒamɔ/
pľúca	/ˈpʎuːt͡sa/
pľuť	/ˈpʎuc/
pňami	[ˈpɲami]
pňoch	[pɲox]
pňom	[pɲom]
pňov	[pɲof]
pňu	[pɲu]
pšenica	/ˈpʃɛɲit͡sa/
pšenice	/ˈpʃɛɲit͡sɛ/
pštros	/ˈpʃtrɔs/
pštrosí	/ˈpʃtrɔsiː/
ŕ	/r̩ː/
-ra	/ra/
Ráb	/ˈraːp/
rabín	/ˈrabiːn/
rad	/Ëˆrat/
rád	/raːd/
rádium	/ˈraːdium/
radla	[ˈradla]
radlami	[ˈradlami]
radlo	[ˈradlo]
radlom	[ˈradlom]
radlu	[ˈradlu]
radón	/ˈradɔːn/
Radoslav	/ˈradɔsɫau̯/
Radovan	/ˈradɔvan/
Radúz	/ˈraduːs/
rajčina	/ˈrajt͡ʃina/
rak	/ˈrak/
Rak	[rak]
Rakovan	[ˈrakovan]
Rakúsko	/ˈrakuːskɔ/
rakúsky	/ˈrakuːski/
rameno	/ˈramɛnɔ/
rasca	/ˈrast͡sa/
Rastislav	/ˈrascisɫau̯/
rastlina	/ˈrastlina/
Rasťo	/ˈrascɔ/
rátať	/ˈraːtac/
raz	/ˈras/
ráz	/ˈraːs/
raňajkovať	/ˈraɲajkɔvac/
raňajky	/ˈraɲajki/
raž	/ˈraʃ/
rebro	/ˈrɛbrɔ/
Regína	/ˈrɛɡiːna/
registrované partnerstvo	[reɡistrovaneː partnerstvo]
registrovaný	[ˈreɡistrovaniː]
Renáta	/ˈrɛnaːta/
René	/ˈrɛnɛː/
rénium	/ˈrɛːnium/
repica	[ˈrepit͡sa]
republika	/ˈrɛpublika/
revue	/ˈrɛvy/
rezance	/ˈrɛzant͡sɛ/
rezať	/ˈrɛzac/
reč	/ˈrɛt͡ʃ/
reštaurácia	/ˈrɛʃtau̯raːt͡sia/
riad	/ˈri̯at/
riaditeľ	/ˈri̯aɟicɛʎ/
riadiť	/ˈri̯aɟic/
ríbezľa	/ˈriːbɛzʎa/
Richard	/ˈrixart/
riedky	/ˈri̯ɛtki/
rieka	/ˈri̯ɛka/
riečka	/ˈri̯ɛt͡ʃka/
Riha	[ˈriɦa]
Rím	/ˈriːm/
Rimanom	/ˈrimanɔm/
rímsky	/ˈriːmski/
ringlota	/ˈriŋɡɫɔta/
rite	[ˈrite]
riti	/ˈrici/
rití	/ˈriciː/
ritiam	[ˈriti̯am]
ritný otvor	/ˈritniː ɔtvɔr/
riziko	/ˈrizikɔ/
Rišo	[ˈriʃo]
riť	/ˈric/
rob	[rop]
Róbert	/ˈrɔːbɛrt/
robí	[ˈrobiː]
robiac	[ˈrobi̯at͡s]
robil	[ˈrobil]
robila	[ˈrobila]
robilo	[ˈrobilo]
robím	[ˈrobiːm]
robíme	[ˈrobiːme]
robíte	[ˈrobiːte]
robíš	[ˈrobiːʃ]
robiť	[ˈrobic]
robota	/ˈrɔbɔta/
robotník	/ˈrɔbɔtɲiːk/
rodina	/ˈrɔɟina/
rodinný	/ˈrɔɟinniː/
ródium	/ˈrɔːdium/
roentgenium	/ˈrɛnɡɛnium/
roh	/ˈrɔx/
roj	/ˈrɔj/
Rojek	[ˈrojek]
Rojka	[ˈrojka]
Rojko	[ˈrojko]
rok	/ˈrɔk/
rokov	/ˈrɔkɔu̯/
Roland	/ˈrɔɫant/
Róm	/ˈrɔːm/
Roman	/ˈrɔman/
Rómka	/ˈrɔːmka/
Rosa	[Ëˆrosa]
Rosina	[ˈrosina]
rovnaký	/ˈrɔvnakiː/
Rozália	/ˈrɔzaːlia/
rozdelenie	[ˈrozdeleni̯e]
rozdeliť	/ˈrɔzɟɛlic/
rozhodnutie	/ˈrɔzɦɔdnuci̯ɛ/
rozhodnúť	/ˈrɔzɦɔdnuːc/
rozmarín	/ˈrɔzmariːn/
rozmaznaný	/ˈrɔzmaznaniː/
rozmaznať	/ˈrɔzmaznac/
rozsobáš	/ˈrɔssɔbaːʃ/
roztomilý	/ˈrɔstɔmiliː/
rozum	/ˈrɔzum/
rozumieť	/ˈrɔzumi̯ɛc/
rozumný	/ˈrɔzumniː/
roční	/ˈrɔt͡ʃniː/
ročný	/ˈrɔt͡ʃniː/
roľa	/ˈrɔʎa/
hlave	[ˈɦlave]
denne	[ˈdene]
hora	[ˈɦora]
nosoch	[ˈnosox]
nosmi	[ˈnosmi]
koláčik	[ˈkolaːt͡ʃik]
koláčom	[ˈkolaːt͡ʃom]
koláču	[ˈkolaːt͡ʃu]
koláči	[ˈkolaːt͡ʃi]
koláča	[ˈkolaːt͡ʃa]
darovať	[ˈdarovac]
zaspať	[ˈzaspac]
na zdravie	[na zdravi̯e]
cestovať	[ˈt͡sestovac]
palec na nohe	[palet͡s na noɦe]
pieh	[pi̯ex]
pehy	[ˈpeɦi]
pehách	[ˈpeɦaːx]
pehám	[ˈpeɦaːm]
pohára	[ˈpoɦaːra]
rožok	/ˈrɔʒɔk/
rubídium	/ˈrubiːdium/
rúd	[ruːt]
ruda	/ˈruda/
rudám	[ˈrudaːm]
Rudo	/ˈrudɔ/
Rudolf	/ˈrudɔɫf/
rudu	[ˈrudu]
rúk	[ruːk]
ruka	/ˈruka/
ruke	[ˈruke]
ruksak	/ˈruksak/
ruky	[ˈruki]
rumanček	/ˈrumant͡ʃɛk/
Rumunsko	/ˈrumunskɔ/
rumunčina	/ˈrumunt͡ʃina/
runa	/ˈru.na/
rúno	/ˈruːnɔ/
Rus	/ˈrus/
Ruska	/ˈruska/
Rusko	/ˈruskɔ/
ruský	/ˈruskiː/
Rusnak	[ˈrusnak]
Rusnák	[ˈrusnaːk]
Rút	/ˈruːt/
ruténium	/ˈrutɛːnium/
rutherfordium	/ˈradzɛfɔrdium/
ručička	/ˈrut͡ʃit͡ʃka/
rúčka	/ˈruːt͡ʃka/
ručne	[ˈrut͡ʃne]
rušeň	/ˈruʃɛɲ/
ruština	/ˈruʃcina/
rúž	/ˈruːʃ/
ruža	/ˈruʒa/
Ružena	/ˈruʒɛna/
Ružomberok	[ˈruʒomberok]
ryba	/ˈriba/
rybár	/ˈribaːr/
rybí	/ˈribiː/
rýchly	/ˈriːxli/
rys	/ˈris/
rysy	/ˈrisi/
rytier	/ˈrici̯ɛr/
ryšavec	/ˈriʃavɛt͡s/
ryšiak	/ˈriʃi̯ak/
röntgen	/ˈrɛntɡɛn/
röntgenovať	/ˈrɛntɡɛnɔvac/
s	/s/
sa	/sa/
Sabína	/ˈsabiːna/
sad	/sad/
sade	[Ëˆsade]
sadoch	[ˈsadox]
sadov	[ˈsadof]
sadza	[ˈsad͡za]
sága	/ˈsaːɡa/
sakristia	/ˈsakristia/
samárium	/ˈsamaːrium/
Samoa	/ˈsamɔa/
samodruhý	/ˈsamɔdruɦiː/
samohláska	[ˈsamoɦlaːska]
samovražda	/ˈsamɔvraʒda/
Samuel	/ˈsamuɛɫ/
samuraj	/ˈsamuraj/
samurajka	/ˈsamurajka/
Sára	/ˈsaːra/
Sardínia	/ˈsardiːnia/
Saudská Arábia	/ˈsautskaː araːbia/
Saša	/ˈsaʃa/
sať	/ˈsac/
schéma	/ˈsxɛːma/
schod	/ˈsxɔt/
schody	/ˈsxɔdi/
schopnosť	/ˈsxɔpnɔsc/
schopný	/ˈsxɔpniː/
schudnúť	/ˈsxudnuːc/
Scípio	/ˈst͡siːpiɔ/
seaborgium	/ˈsiːbɔrɡium/
seba	/ˈsɛba/
sebe	/ˈsɛbɛ/
sebec	/ˈsɛbɛt͡s/
sedem	/ˈsɛɟɛm/
sedemnásť	/ˈsɛɟɛmnaːsc/
Segedín	/ˈsɛɡɛdiːn/
segment	/ˈseɡment/
sekera	/ˈsɛ.kɛ.ra/
sekúnd	/ˈsɛkuːnt/
sekunda	/ˈsɛkunda/
selén	/ˈsɛlɛːn/
semeno	/ˈsɛmɛnɔ/
sen	/ˈsɛn/
sendvič	/ˈsɛndvit͡ʃ/
sene	[Ëˆsene]
seno	/ˈsɛnɔ/
senom	[ˈsenom]
sepsa	/ˈsɛpsa/
september	/ˈsɛptɛmbɛr/
Sergej	/ˈsɛrɡɛj/
Servác	/ˈsɛrvaːt͡s/
servus	/ˈsɛrvus/
sestra	/ˈsɛstra/
sestrin	/ˈsɛstrin/
sestrička	/ˈsɛstrit͡ʃka/
sever	[ˈsever]
Severín	/ˈsɛvɛriːn/
sex	/ˈsɛks/
sexu	/ˈsɛksu/
sexuálna orientácia	/ˈsɛksuaːɫna ɔriɛntaːt͡sia/
Shetland	/ˈʃɛtlɛnt/
shetlandský	/ʃɛtlɛndskiː/
Shetlandy	/ˈʃɛtlɛndi/
si	[si]
siaha	/ˈsi̯aɦa/
sídlo	/ˈsiːdɫɔ/
Sidónia	/ˈsidɔːnia/
siedmy	/ˈsi̯ɛdmi/
sieň	[si̯eɲ]
silná interakcia	/ˈsiɫnaː intɛrakt͡sia/
Silvia	/ˈsiɫvia/
Simona	/ˈsimɔna/
síra	/ˈsiːra/
sirôtka	/ˈsiru̯ɔtka/
sirôtočka	/ˈsiru̯ɔtɔt͡ʃka/
sitina	[ˈsitina]
sito	[Ëˆsito]
situácia	/ˈsituaːt͡sia/
sivý	[ˈsiviː]
-ska	/ska/
skala	/ˈskaɫa/
skald	/skaɫt/
	
sklz	/skɫ̩s/
skoro	[Ëˆskoro]
skorocel	/ˈskɔrɔt͡sɛɫ/
skratka	/ˈskratka/
skrutka	/ˈskrutka/
skrutkovač	/ˈskrutkɔvat͡ʃ/
skrutkovať	/ˈskrutkɔvac/
skrz	/ˈskr̩s/
skuhroš	/ˈskuɦrɔʃ/
skupáň	/ˈskupaːɲ/
Skutky apoštolov	/ˈskutki apɔʃtɔɫɔu̯/
-sky	/ski/
-ský	/skiː/
slabá interakcia	/ˈsɫaba intɛrakt͡sia/
slabika	[ˈslabika]
slabý	/ˈsɫa.biː/
sladký	/ˈsɫatkiː/
slanina	/ˈsɫaɲina/
sláva	/ˈsɫaːva/
Sláva	/ˈsɫaːva/
Slávka	/ˈsɫaːu̯ka/
Slavomír	/ˈsɫavɔmiːr/
Slavomíra	/ˈsɫavɔmiːra/
Slavónsko	/ˈsɫavɔːnskɔ/
sláčik	/ˈsɫaːt͡ʃik/
slepo	[ˈslepo]
slepý	/ˈslɛpiː/
sliepka	/ˈsli̯ɛpka/
sliepočka	/ˈsli̯ɛpɔt͡ʃka/
Sliezsko	/ˈsli̯ɛsskɔ/
slimák	/ˈslimaːk/
Sliva	[ˈsliva]
slivka	/ˈsliu̯ka/
Slivka	/ˈsliu̯ka/
slivovica	/ˈslɪ.vo.vɪ.tsa/
sĺnc	/sɫ̩ːnt͡s/
slnce	/ˈsɫ̩nt͡sɛ/
slnečný	/ˈsɫ̩ɲɛt͡ʃˌniː/
slnečný vietor	/ˈsɫ̩ɲɛt͡ʃniː vi̯ɛtɔr/
slniečko	/ˈsɫ̩ɲi̯ɛt͡ʃkɔ/
sĺnk	/sɫ̩ːŋk/
slnko	/ˈsɫ̩ŋkɔ/
sloboda	/ˈsɫɔbɔda/
slobodná vôľa	/ˈsɫɔbɔdnaː vu̯ɔʎa/
sloj	/sɫɔj/
slon	/ˈsɫɔn/
slonej	[ˈslonej]
sloní	/ˈsɫɔɲiː/
slonia	[ˈsloni̯a]
slonica	/ˈslɔ.ni.t͡sa/
slonie	[ˈsloni̯e]
sloniu	[ˈsloni̯u]
Slováci	/ˈsɫɔvaːt͡si/
Slovák	/ˈsɫɔvaːk/
Slovan	/ˈsɫɔvan/
slovanský	/ˈsɫɔvanskiː/
Slovenka	/ˈsɫɔvɛŋka/
slovenskí	/ˈsɫɔvɛnskiː/
Slovensko	[ˈslovensko]
slovensky	/ˈsɫɔvɛnski/
slovenský	/ˈsɫɔvɛnskiː/
slovenčina	/ˈsɫɔvɛnt͡ʃina/
sloveso	/ˈsɫɔvɛsɔ/
Slovinec	/ˈsɫɔviɲɛt͡s/
Slovinka	/ˈsɫɔviŋka/
Slovinsko	/ˈsɫɔvinskɔ/
slovinský	/ˈsɫɔvinskiː/
slovinčina	/ˈsɫɔvint͡ʃina/
slovník	/sloʋɲiːk/
hlave	[ˈɦlave]
denne	[ˈdene]
hora	[ˈɦora]
nosoch	[ˈnosox]
nosmi	[ˈnosmi]
koláčik	[ˈkolaːt͡ʃik]
koláčom	[ˈkolaːt͡ʃom]
koláču	[ˈkolaːt͡ʃu]
koláči	[ˈkolaːt͡ʃi]
koláča	[ˈkolaːt͡ʃa]
darovať	[ˈdarovac]
zaspať	[ˈzaspac]
na zdravie	[na zdravi̯e]
cestovať	[ˈt͡sestovac]
palec na nohe	[palet͡s na noɦe]
pieh	[pi̯ex]
pehy	[ˈpeɦi]
pehách	[ˈpeɦaːx]
pehám	[ˈpeɦaːm]
pohára	[ˈpoɦaːra]
slovníka	/sɫoʋɲiːka/
slovníkmi	/sɫoʋɲiːkmi/
slovníkoch	/sɫoʋɲiːkox/
slovníkom	/sɫoʋɲiːkom/
slovníkov	/sɫoʋɲiːkou̯/
slovníku	/sɫoʋɲiːku/
slovníky	/sɫoʋɲiːki/
slovo	/ˈsɫɔvɔ/
sluch	/ˈsɫux/
sluchom	[ˈsluxom]
sluha	/ˈsɫuɦa/
služba	[ˈsluʒba]
sĺz	/sɫ̩ːs/
slza	/ˈsɫ̩za/
slzička	/ˈsɫ̩zit͡ʃka/
smäd	/ˈsmɛt/
smädiť	/ˈsmɛɟic/
smädný	/ˈsmed.niː/
smetiar	/ˈsmɛci̯ar/
smiať sa	/ˈsmi̯ac sa/
smiech	/ˈsmi̯ɛx/
smotana	/ˈsmɔtana/
smrek	[smrek]
smrekovec	/ˈsmrɛkɔvɛt͡s/
smrti	/ˈsmr̩ci/
smrtonosný	/ˈsmr̩tɔnɔsniː/
smršť	/smr̩ʃc/
smrť	/ˈsmr̩c/
smutný	/ˈsmutniː/
snáď	/ˈsnaːc/
sneh	/ˈsɲɛx/
snežiť	/ˈsɲɛʒic/
snob	/ˈsnɔp/
so	/sÉ”/
sobáš	/ˈsɔbaːʃ/
sobota	/ˈsɔbɔta/
sôch	/su̯ox/
socha	/ˈsɔxa/
soche	[ˈsoxe]
socialistický	/ˈsɔt͡sialistit͡skiː/
socializmus	/ˈsɔt͡sializmus/
sociálny	/ˈsɔt͡siaːɫni/
sodík	/ˈsɔɟiːk/
Sofoniáš	/ˈsɔfɔniaːʃ/
softvér	/ˈsɔftvɛːr/
sojka	/ˈsɔjka/
sokol	/ˈso̞ko̞l/
Sokrates	/ˈsɔkratɛs/
som	/ˈsɔm/
somár	/ˈsɔmaːr/
somarina	/ˈsɔmarina/
sopka	/ˈsɔpka/
sova	/ˈsɔva/
sôvä	/ˈsu̯ɔvɛ/
sove	[ˈsove]
sovietsky	/ˈsɔvi̯ɛtski/
soľ	/ˈsɔʎ/
Soňa	/ˈsɔɲa/
spajvér	/ˈspajvɛːr/
spálňa	/ˈspaːɫɲa/
spať	/ˈspac/
spln	/ˈspɫ̩n/
Spojené kráľovstvo	/ˈspɔjɛnɛː kraːʎɔu̯stvɔ/
spojka	/ˈspɔjka/
spoločnosť	/ˈspɔɫɔt͡ʃnɔsc/
spoluhláska	[ˈspoluɦlaːska]
spôsob	/ˈspu̯ɔsɔp/
správa	/ˈspraːva/
správať	/ˈspraːvac/
spraviť	/ˈspravic/
spŕch	/spr̩ːx/
sprcha	/ˈspr̩xa/
spŕška	/ˈspr̩ːʃka/
spyware	/ˈspajvɛːr/
srať	/ˈsrac/
Srb	/ˈsr̩p/
Srbsko	/ˈsr̩pskɔ/
srbský	/ˈsr̩pskiː/
srbčina	[ˈsr̩bt͡ʃina]
sŕdc	/sr̩ːt͡s/
srdca	/ˈsr̩t͡sa/
srdce	/sr̩tsɛ/
srdcia	/ˈsr̩t͡si̯a/
srdciach	/ˈsr̩t͡si̯ax/
srdciam	/ˈsr̩t͡si̯am/
srdciami	/ˈsr̩t͡si̯ami/
srdcom	/ˈsr̩t͡sɔm/
srdcu	/ˈsr̩t͡su/
srdiečko	/ˈsr̩ɟi̯ɛt͡ʃkɔ/
sŕn	/sr̩ːn/
srna	/ˈsr̩na/
srsť	/ˈsr̩sc/
srvátka	/ˈsr̩vaːtka/
sŕňa	/ˈsr̩ːɲa/
stalaktit	/ˈstaɫaktit/
stále	/ˈstaːlɛ/
stan	/ˈstan/
Stanislav	/ˈstaɲisɫau̯/
Stanislava	/ˈstaɲisɫava/
stará matka	/ˈstaraː matka/
starec	/ˈstarɛt͡s/
starena	/ˈstarɛna/
stárež	[ˈstaːreʃ]
starká	/ˈstarkaː/
starký	/ˈstarkiː/
starogréčtina	/ˈstarɔɡrɛːt͡ʃcina/
starostlivosť	/ˈstarɔstlivɔsc/
starý	/ˈstariː/
starý otec	/ˈstariː ɔcɛt͡s/
starček	/ˈstart͡ʃɛk/
starší	/ˈstarʃiː/
stať	/ˈstac/
stáť	/ˈstaːc/
ste	/ˈscɛ/
steblo	[ˈsteblo]
stehlík	/ˈscɛɦʎiːk/
Stela	/ˈstɛɫa/
stena	/ˈscɛna/
stĺcť	/stɫ̩ːt͡sc/
stĺp	/ˈstɫ̩ːp/
sto	/ˈstɔ/
stôl	/stu̯ɔɫ/
stolička	/ˈstɔlit͡ʃka/
storočie	/ˈstorot͡ʃi̯e/
stotisíci	[ˈstotisiːt͡si]
strach	/strax/
strachmi	/straxmi/
strachoch	/straxox/
strachom	/straxom/
strachov	/straxou̯/
strachu	/straxu/
strachy	/straxi/
straka	/ˈstraka/
Straka	[ˈstraka]
strana	/ˈstrana/
stranách	[ˈstranaːx]
stranám	[ˈstranaːm]
stranami	[ˈstranami]
stranu	[ˈstranu]
strany	[ˈstrani]
strategický	/ˈstratɛɡit͡skiː/
strážiť	/ˈstraːʒic/
strecha	/ˈstrɛxa/
streda	/ˈstreda/
stredník	/ˈstrɛdɲiːk/
strela	/ˈstrɛɫa/
strelec	/ˈstrɛlɛt͡s/
Strelec	[ˈstrelet͡s]
stretnutie	/ˈstrɛtnuci̯ɛ/
stretnúť	/ˈstrɛtnuːc/
striebro	/ˈstri̯ɛbrɔ/
striga	/ˈstri.ɡa/
strk	/str̩k/
strmý	/ˈstr̩miː/
stroj	/ˈstrɔj/
stroja	/ˈstrɔja/
stroje	/ˈstrɔjɛ/
stroji	/ˈstrɔji/
strojmi	/ˈstrɔjmi/
strojoch	/ˈstrɔjɔx/
strojom	/ˈstrɔjɔm/
strojov	/ˈstrɔjɔu̯/
stroju	/ˈstrɔju/
strom	/strɔm/
stromami	/ˈstrɔmami/
strome	/ˈstrɔmɛ/
stromoch	/ˈstrɔmɔx/
stromom	/ˈstrɔmɔm/
stromov	/ˈstrɔmɔu̯/
stromu	/ˈstrɔmu/
stromy	/ˈstrɔmi/
stroncium	/ˈstrɔnt͡sium/
strúhať	[ˈstruːɦac]
struk	/ˈstruk/
strukovina	/ˈstrukɔvina/
strukoviny	/ˈstrukɔvini/
struna	/ˈstruna/
strúčik	/ˈstruːt͡ʃik/
strýc	/ˈstriːt͡s/
stryná	/ˈstrinaː/
strč	/ˈstr̩t͡ʃ/
strž	/ˈstr̩ʃ/
-stvo	/stvɔ/
sú-	/ˈsuː/
suchý	/ˈsuxiː/
súd	/ˈsuːt/
sudca	/ˈsutt͡sa/
sudetský	/sʊdɛtskiː/
Sudety	/ˈsudɛti/
sudlica	[ˈsudlit͡sa]
súdruh	/ˈsuːdrux/
suka	/ˈsuka/
sukienka	/ˈsuki̯ɛŋka/
sukne	/ˈsukɲɛ/
sukničkár	/ˈsukɲit͡ʃkaːr/
súkromný	/ˈsuːkrɔmniː/
sukňa	/ˈsukɲa/
súlož	/ˈsuːɫɔʃ/
súostrovie	/ˈsuːɔstrɔvi̯ɛ/
sup	/ˈsup/
hlave	[ˈɦlave]
denne	[ˈdene]
hora	[ˈɦora]
nosoch	[ˈnosox]
nosmi	[ˈnosmi]
koláčik	[ˈkolaːt͡ʃik]
koláčom	[ˈkolaːt͡ʃom]
koláču	[ˈkolaːt͡ʃu]
koláči	[ˈkolaːt͡ʃi]
koláča	[ˈkolaːt͡ʃa]
darovať	[ˈdarovac]
zaspať	[ˈzaspac]
na zdravie	[na zdravi̯e]
cestovať	[ˈt͡sestovac]
palec na nohe	[palet͡s na noɦe]
pieh	[pi̯ex]
pehy	[ˈpeɦi]
pehách	[ˈpeɦaːx]
pehám	[ˈpeɦaːm]
pohára	[ˈpoɦaːra]
súper	/ˈsuːpɛr/
súrne	/ˈsuːrɲɛ/
súrny	/ˈsuːrni/
sústava	/ˈsuːstava/
súčasný	/ˈsuːt͡ʃasniː/
sušič	/ˈsu.ʃit͡ʃ/
sušička	/ˈsuʃit͡ʃka/
súťaž	/ˈsuːcaʃ/
svadobný	/ˈsvadɔbniː/
svahilčina	/ˈsvaɦiɫt͡ʃina/
svastika	/ˈsvastika/
svastiku	/ˈsvastiku/
svätá	[ˈsvætaː]
sväté	[ˈsvæteː]
svätí	[ˈsvætiː]
Svätopluk	/ˈsvɛtɔpɫuk/
svätú	[ˈsvætuː]
svätý	/ˈsvætiː/
Svätý Tomáš	/ˈsvɛtiː tɔmaːʃ/
svätyňa	/ˈsvɛtiɲa/
svedomí	/ˈsvɛ.dɔ.miː/
svedomie	/ˈsvɛdɔmi̯e/
svet	/ˈsvɛt/
sveta	/ˈsvɛta/
svete	/ˈsvɛcɛ/
Svetlana	/ˈsvɛtɫana/
svetlo	/ˈsvɛtɫɔ/
svetmi	/ˈsvɛtmi/
svetoch	/ˈsvɛtɔx/
svetom	/ˈsvɛtɔm/
svetov	/ˈsvɛtɔu̯/
svetový	/ˈsvɛtɔviː/
Svetozár	/ˈsvɛtɔzaːr/
svetu	/ˈsvɛtu/
svety	/ˈsvɛti/
Sveťo	/ˈsvɛcɔ/
svíb	[sviːp]
svieca	/ˈsvi̯ɛt͡sa/
sviečka	/ˈsvi̯ɛt͡ʃka/
sviečkach	/ˈsvi̯ɛt͡ʃkax/
sviečkam	/ˈsvi̯ɛt͡ʃkam/
sviečkami	/ˈsvi̯ɛt͡ʃkami/
sviečke	/ˈsvi̯ɛt͡ʃkɛ/
sviečkou	/ˈsvi̯ɛt͡ʃkɔu̯/
sviečku	/ˈsvi̯ɛt͡ʃku/
sviečky	/ˈsvi̯ɛt͡ʃki/
sviečok	/ˈsvi̯ɛt͡ʃɔk/
sviečočka	/ˈsvi̯ɛt͡ʃɔt͡ʃka/
sviňa	[ˈsviɲa]
svoj	/ˈsvɔj/
svokor	/ˈsvɔkɔr/
svokra	/ˈsvɔkra/
sýkorka	/ˈsiːkɔrka/
syn	/sin/
synáčik	/ˈsinaːt͡ʃik/
synergia	/ˈsi.nɛr.ɡi.a/
synovia	/ˈsi.no.vi̯a/
syntax	/ˈsin.taks/
syntaxe	/ˈsintaksɛ/
syntéza	/ˈsintɛːza/
synček	/ˈsint͡ʃɛk/
syr	/ˈsir/
syra	[Ëˆsira]
syre	[Ëˆsire]
	
syrmi	[ˈsirmi]
syroch	[ˈsirox]
syrom	[ˈsirom]
syrov	[ˈsirof]
sýrsky	/ˈsiːr.ski/
syru	[ˈsiru]
syry	[ˈsiri]
tabak	/Ëˆtabak/
Tábor	/ˈtaːbɔr/
tabu	/ˈtabu/
Tadžik	/ˈtad͡ʒik/
Tadžikistan	/ˈta.d͡ʒi.ki.stan/
tágo	/ˈtaːɡɔ/
takmer	/ˈtakmɛr/
taký	/ˈtakiː/
takýto	/ˈtakiːtɔ/
takže	[ˈtakʒe]
Taliansko	/ˈtali̯anskɔ/
taliansky	/ˈtali̯anski/
taliančina	/ˈtali̯ant͡ʃina/
tálium	/ˈtaːlium/
tam	/Ëˆtam/
Tamara	/ˈtamara/
tamhľa	/ˈtamɦʎa/
tanec	/ˈta.ɲet͡s/
tangá	/ˈtaŋɡaː/
tango	/ˈtaŋɡɔ/
tanier	/ˈtaɲi̯ɛr/
tanierik	/ˈtaɲi̯ɛrik/
tantal	/ˈtantaɫ/
tapeta	/ˈtapɛta/
Tatiana	/ˈtati̯ana/
Tatry	/ˈta.tri/
teba	[ˈteba]
technécium	/ˈtɛxnɛːt͡sium/
technológia	/ˈtɛxnɔɫɔːɡia/
tehla	/ˈcɛɦɫa/
tehlička	/ˈcɛɦʎit͡ʃka/
teizmus	/ˈtɛizmus/
tekvica	/ˈcɛkvit͡sa/
tela	/ˈcɛɫa/
telá	/ˈcɛɫaː/
telách	/ˈcɛɫaːx/
telám	/ˈcɛɫaːm/
telami	/ˈcɛɫami/
tele	/ˈcɛlɛ/
telefón	/ˈtɛlɛfɔːn/
teleskop	/ˈtɛlɛskɔp/
telíčko	/ˈcɛʎiːt͡ʃkɔ/
telo	/ˈcɛɫɔ/
telom	/ˈcɛɫɔm/
telu	/ˈcɛɫu/
telúr	/ˈtɛɫuːr/
téma	/ˈte̞ːma/
temer	[Ëˆtemer]
Temešvár	/ˈtɛmɛʃvaːr/
temnota	/ˈcɛmnɔta/
temný	/ˈcɛmniː/
ten	/tɛn/
tenkí	[ˈtenkiː]
tenkú	[ˈtenkuː]
tenký	/ˈcɛŋkiː/
Teodor	/ˈtɛɔdɔr/
teológia	/ˈtɛɔɫɔːɡia/
tepať	/ˈcɛpac/
teplú	[ˈtepluː]
teplý	/ˈcɛpliː/
teraz	/ˈtɛras/
terbium	/ˈtɛrbium/
Terézia	/ˈtɛrɛːzia/
terminológia	/ˈtɛrminɔɫɔːɡia/
Terst	/tɛrst/
testosterón	/ˈtɛstɔstɛrɔːn/
tesť	/ˈcɛsc/
teta	/ˈcɛta/
-teľ	/cɛʎ/
teľa	/ˈcɛʎa/
tiahnuť	/ˈci̯aɦnuc/
tibetčina	/ˈtibɛtt͡ʃina/
Tibor	/ˈcibɔr/
Tichomír	/ˈcixɔmiːr/
tichú	[ˈtixuː]
tiecť	[ti̯et͡sc]
tiel	/ˈci̯ɛɫ/
tieň	/ˈci̯ɛɲ/
tiež	/ˈci̯ɛʃ/
Tigris	/ˈtiɡris/
tigriňa	/ˈtiɡriɲa/
Timotej	/ˈtimɔtɛj/
Tisa	/ˈci.sa/
tisíc	/ˈcisiːt͡s/
tisíci	/ˈcisiːt͡si/
titán	/ˈtitaːn/
tkáč	/ˈtkaːt͡ʃ/
tkáčka	/ˈtkaːt͡ʃka/
tlač	/ˈtɫat͡ʃ/
tlačiť	/ˈtɫat͡ʃic/
tlačová konferencia	/ˈtɫat͡ʃɔvaː kɔnfɛrɛnt͡sia/
tlačovka	/ˈtɫat͡ʃɔu̯ka/
tĺcť	/tɫ̩ːt͡sc/
tĺk	/tɫ̩ːk/
tlmač	/ˈtɫ̩mat͡ʃ/
tlmočník	/ˈtɫ̩mɔt͡ʃɲiːk/
tlstý	/ˈtɫ̩stiː/
tma	/ˈtma/
tmavý	/ˈtmaviː/
tobôž	/ˈtɔbu̯ɔʃ/
toho	/ˈtɔɦɔ/
tok	/ˈtɔk/
Tokio	/ˈtɔkiɔ/
tokoferol	/ˈtɔkɔfɛrɔɫ/
Tomáš	/ˈtɔmaːʃ/
topánka	/ˈtɔpaːŋka/
topánky	/ˈtɔpaːŋki/
topánočka	/ˈtɔpaːnɔt͡ʃka/
tórium	/ˈtɔːrium/
totalitarizmus	/ˈtɔtalitarizmus/
tovar	/ˈtɔvar/
toxický	/ˈtoksit͡skiː/
traktor	/ˈtraktɔr/
traktorista	[ˈtraktorista]
tráva	/ˈtraːva/
tráviaci	/ˈtraːvi̯at͡si/
trávička	/ˈtraːvit͡ʃka/
treba	/ˈtrɛba/
tretí	/ˈtrɛciː/
trh	/tr̩x/
trhu	/ˈtr̩.ɦu/
tri	/ˈtri/
tridsať	/ˈtrit͡sac/
triesočka	/ˈtri̯ɛsɔt͡ʃka/
triezvy	/ˈtri̯ɛzvi/
trinásť	/ˈtrinaːsc/
Trnava	[ˈtrnava]
tŕnie	/ˈtr̩ːɲi̯ɛ/
hlave	[ˈɦlave]
denne	[ˈdene]
hora	[ˈɦora]
nosoch	[ˈnosox]
nosmi	[ˈnosmi]
koláčik	[ˈkolaːt͡ʃik]
koláčom	[ˈkolaːt͡ʃom]
koláču	[ˈkolaːt͡ʃu]
koláči	[ˈkolaːt͡ʃi]
koláča	[ˈkolaːt͡ʃa]
darovať	[ˈdarovac]
zaspať	[ˈzaspac]
na zdravie	[na zdravi̯e]
cestovať	[ˈt͡sestovac]
palec na nohe	[palet͡s na noɦe]
pieh	[pi̯ex]
pehy	[ˈpeɦi]
pehách	[ˈpeɦaːx]
pehám	[ˈpeɦaːm]
pohára	[ˈpoɦaːra]
trolejbus	/ˈtrɔlɛjbus/
trona	/ˈtrɔna/
trs	/tr̩s/
trsť	/tr̩sc/
tŕň	/tr̩ːɲ/
tuk	/tuk/
tulipán	/ˈtulipaːn/
túlium	/ˈtuːlium/
tupý	/ˈtupiː/
tur	/ˈtur/
Turecko	/ˈturɛt͡skɔ/
Turek	/ˈturɛk/
turista	/ˈturista/
turistika	/ˈturistika/
turizmus	/ˈturizmus/
Turkyňa	/ˈturkiɲa/
turmi	[ˈturmi]
turnaj	/ˈturnaj/
turoch	[ˈturox]
turom	[ˈturom]
turov	[ˈturof]
tury	[ˈturi]
tučniak	/tut͡ʃɲi̯ak/
tužka	/ˈtuʃka/
tvár	/ˈtvaːr/
tvaroh	/ˈtvarɔx/
tvoj	/ˈtvɔj/
tvŕdz	/tvr̩ːt͡s/
tvrdza	/ˈtvr̩d͡za/
ty	/ˈti/
týždeň	/ˈtiːʒɟɛɲ/
ubehlík	/ˈubɦɛliːk/
úbohý	/ˈuːbɔɦiː/
úch	[uːx]
ucha	[ˈuxa]
uchá	[ˈuxaː]
uchách	[ˈuxaːx]
uchám	[ˈuxaːm]
uchami	[ˈuxami]
ucho	/ˈu.xɔ/
uchom	[ˈuxom]
uchu	[ˈuxu]
údolie	/ˈuːdɔʎi̯ɛ/
udrieť	/ˈudri̯ɛc/
ufňukaný	/ˈufɲukaniː/
uhla	[ˈuɦla]
uhlami	[ˈuɦlami]
uhle	[ˈuɦle]
uhlie	/ˈuhʎi̯ɛ/
uhlík	/ˈuɦʎiːk/
uhličitý	/ˈuɦʎit͡ʃitiː/
uhloch	[ˈuɦlox]
uhlom	[ˈuɦlom]
uhlov	[ˈuɦlof]
uhlu	[ˈuɦlu]
uhol	/ˈuɦɔɫ/
Uhor	[ˈuɦor]
uhorka	/ˈuɦɔrka/
Uhorka	/ˈuɦɔrka/
uja	[Ëˆuja]
ujca	[ˈujt͡sa]
ujcoch	[ˈujt͡sox]
ujcom	[ˈujt͡som]
ujcov	[ˈujt͡sof]
ujcovi	[ˈujt͡sovi]
ujec	/ˈujɛt͡s/
ujo	/ˈujɔ/
ujoch	[ˈujox]
ujom	[ˈujom]
ujov	[ˈujof]
ujovi	[ˈujovi]
ujček	/ˈujt͡ʃɛk/
Ukrajina	/ˈukrajina/
ukrajinský	/ˈukrajinskiː/
ukrajinčina	/ˈukrajint͡ʃina/
ulíc	/ˈu.ɫiːt͡s/
ulica	/ˈu.ɫi.t͡sa/
ulicami	/ˈu.ɫi.t͡sa.mi/
ulice	/ˈu.ɫi.t͡se/
ulici	/ˈu.ɫi.t͡si/
uliciach	/ˈu.ɫi.t͡si̯ax/
uliciam	/ˈu.ɫi.t͡si̯am/
ulicou	/ˈu.ɫi.t͡sɔw/
ulicu	/ˈu.ɫi.t͡su/
um	/ˈum/
umenie	/ˈumɛɲi̯ɛ/
umrieť	/ˈumri̯ɛc/
univerzita	/ˈunivɛrzita/
univerzitný	/ˈunivɛrzitniː/
upír	/ˈupiːr/
upratať	/ˈupratac/
úrad	/ˈuːrat/
urán	/ˈuraːn/
uraninit	[ˈuraninit]
Urban	/Ëˆurban/
urgentný	/ˈurɡɛntniː/
urobiť	/ˈurɔbic/
urtikárie	/ˈurtikaːriɛ/
Uruguaj	/ˈuruɡvaj/
určite	/ˈurt͡ʃicɛ/
Uršuľa	/ˈurʃuʎa/
uspávanka	[ˈuspaːvanka]
ústa	/ˈuːsta/
utečenec	/ˈucɛt͡ʃɛɲɛt͡s/
utešený	/ˈucɛʃɛniː/
utorok	/ˈutɔrɔk/
útroba	/ˈuː.trɔ.ba/
Uzbek	/ˈuz.bek/
Uzbekistan	/ˈuzbɛkistan/
území	/ˈuːzɛmiː/
územie	/ˈuːzɛmi̯ɛ/
úzky	/ˈuːski/
uzol	[ˈuzol]
učiteľ	/ˈu.t͡ʃi.celʲ/
učiteľka	/ˈu.t͡ʃi.celʲ.ka/
ušami	[ˈuʃami]
uši	[ˈuʃi]
uší	[ˈuʃiː]
ušiam	[ˈuʃi̯am]
uško	/ˈuʃkɔ/
ušnica	/ˈuʃɲit͡sa/
úžas	[ˈuːʒas]
úžera	[ˈuːʒera]
úžerník	[ˈuːʒerniːk]
úžitok	/ˈuːʒitɔk/
užitočnosť	/ˈuʒitɔt͡ʃnɔsc/
užitočný	/ˈuʒitɔt͡ʃniː/
užívateľ	/ˈuʒiːvacɛʎ/
užovka	/ˈuʒɔu̯ka/
užší	/ˈuʃiː/
Václav	/ˈʋaːt͡s.ɫaw/
vädnúť	/ˈvɛdnuːc/
vagína	/ˈvaɡiːna/
Váh	/ˈvaːx/
vajce	/ˈvajt͡sɛ/
valach	/ˈvaɫax/
Valach	/ˈvaɫax/
valaška	/ˈvaɫaʃka/
Valašsko	/ˈvaɫaʃskɔ/
valašský	/ˈvaɫaʃskiː/
Valentín	/ˈvalɛntiːn/
Valentína	/ˈvalɛntiːna/
Valér	/ˈvalɛːr/
Valéria	/ˈvalɛːria/
valkýra	/ˈvaɫkiːra/
valčík	/ˈvaɫt͡ʃiːk/
vanád	/ˈʋa.naːt/
Vanda	/ˈvanda/
vankúš	/ˈvaŋkuːʃ/
Vanuatu	/ˈvanuatu/
vápnik	/ˈʋaːp.ɲik/
Varna	[ˈvarna]
Varšava	/ˈʋar.ʃa.ʋa/
Vasil	/ˈvasiɫ/
Vavrinec	/ˈvavriɲɛt͡s/
väčší	/ˈvɛt͡ʃʃi/
väčšina	/ˈvɛt͡ʃʃina/
vaňa	/ˈvaɲa/
váš	/ˈvaːʃ/
vaše	/ˈʋa.ʃe/
vážka	/ˈvaːʃka/
vdov	/ˈvdɔu̯/
vdovách	/ˈvdɔvaːx/
vdovám	/ˈvdɔvaːm/
vdovami	/ˈvdɔvami/
vdove	/ˈvdɔvɛ/
vdovou	/ˈvdɔvɔu̯/
vdovu	/ˈvdɔvu/
vdovy	/ˈvdɔvi/
vec	/ˈvɛt͡s/
veda	[ˈveda]
vedec	/ˈvɛɟɛt͡s/
vedieť	/ˈvɛɟi̯ɛc/
vedro	/ˈvɛdrɔ/
vedľa	/ˈvɛdʎa/
veko	/ˈvɛkɔ/
Vendelín	/ˈvɛndɛliːn/
verejný	/ˈvɛrɛjniː/
Veronika	/ˈvɛrɔɲiːka/
ves	/ˈʋes/
veselé Vianoce	/ˈvɛsɛɫɛː ˈvi̯anɔt͡sɛ/
vestibul	/ˈvɛstibuɫ/
vetchý	/ˈvɛtxiː/
veternica	/ˈvɛcɛrɲit͡sa/
vetva	/ˈvɛtva/
veverica	/ˈvɛvɛrit͡sa/
večer	/ˈvɛt͡ʃɛr/
večera	/ˈvɛt͡ʃɛra/
večes	/ˈʋe.tʃes/
veľa	/ˈvɛʎa/
veľký	/ˈvɛʎkiː/
veľmi	/ˈvɛʎmi/
veža	/ˈvɛʒa/
vežička	/ˈvɛʒit͡ʃka/
viac	/ˈvi̯at͡s/
Vianoce	/ˈvi̯anɔt͡s/
viať	/ˈvi̯ac/
víchor	/ˈviːxɔr/
vidiecky	/ˈviɟi̯ɛt͡ski/
vidiek	[ˈviɟieːk]
hlave	[ˈɦlave]
denne	[ˈdene]
hora	[ˈɦora]
nosoch	[ˈnosox]
nosmi	[ˈnosmi]
koláčik	[ˈkolaːt͡ʃik]
koláčom	[ˈkolaːt͡ʃom]
koláču	[ˈkolaːt͡ʃu]
koláči	[ˈkolaːt͡ʃi]
koláča	[ˈkolaːt͡ʃa]
darovať	[ˈdarovac]
zaspať	[ˈzaspac]
na zdravie	[na zdravi̯e]
cestovať	[ˈt͡sestovac]
palec na nohe	[palet͡s na noɦe]
pieh	[pi̯ex]
pehy	[ˈpeɦi]
pehách	[ˈpeɦaːx]
pehám	[ˈpeɦaːm]
pohára	[ˈpoɦaːra]
vidieť	/ˈviɟi̯ɛc/
vidlička	/ˈvidʎit͡ʃka/
viedenský	/ˈvi̯ɛɟɛnskiː/
Viedeň	/ˈvi̯ɛɟɛɲ/
vier	[viÌ¯er]
viera	/ˈvi̯ɛra/
Viera	/ˈvi̯ɛra/
vierach	[ˈvi̯erax]
vieram	[ˈvi̯eram]
vierami	[ˈvi̯erami]
viere	[ˈvi̯ere]
Vieroslava	/ˈvi̯ɛrɔsɫava/
vieru	[ˈvi̯eru]
viesť	/ˈvi̯ɛsc/
Vietnam	/ˈvi̯ɛtnam/
vietor	/ˈvi̯ɛtɔr/
viezť	/ˈvi̯ɛsc/
víkend	/ˈʋiː.kent/
Viking	/ˈvikiŋɡ/
Viktor	/ˈviktɔr/
Viktória	/ˈviktɔːria/
víla	/ˈʋiː.ɫa/
Viliam	/ˈviliam/
Vilma	/ˈviɫma/
Vilnius	/ˈviɫɲi̯us/
Vincent	/ˈvint͡sɛnt/
víno	/ˈviːnɔ/
vinš	/ˈvinʃ/
Viola	/ˈviɔɫa/
Visla	/ˈvisɫa/
Vít	/ˈviːt/
vitamín	/ˈvitamiːn/
vitráž	/ˈʋitraːʃ/
víťaz	/ˈviːcas/
Víťazoslav	/ˈviːcazɔsɫau̯/
Víťazoslava	/ˈviːcazɔsɫava/
víťazstvo	/ˈviːcasstvɔ/
Vladimír	/ˈvɫaɟimiːr/
Vladimíra	/ˈvɫaɟimiːra/
Vladislav	/ˈvɫaɟisɫau̯/
vlaha	/ˈvɫaɦa/
vlajočka	/ˈvɫajɔt͡ʃka/
vlani	/ˈvɫaɲi/
vlas	/ˈvɫas/
vlásočnica	/ˈvɫaːsɔt͡ʃɲit͡sa/
Vlasta	/ˈvɫasta/
Vlastimil	/ˈvɫascimiɫ/
vlastné meno	/ˈvɫastnɛː mɛnɔ/
vlastný	/ˈvɫastniː/
vlasť	/ˈʋɫasc/
vláčik	/ˈvɫaːt͡ʃik/
vĺh	/ˈʋɫ̩ːx/
vlha	/ˈʋɫ̩ɦa/
vlk	/ˈvɫ̩k/
vlkolak	/ˈvɫ̩kɔɫak/
vĺn	/ˈʋɫ̩ːn/
vlna	/ˈvɫ̩na/
Vltava	[ˈvl̩tava]
vĺča	[ˈvl̩ːt͡ʃa]
vlčica	/ˈvɫ̩t͡ʃit͡sa/
vnuk	/ˈvnuk/
vnútornosti	/ˈvnuːtɔrnɔsc/
vnúčik	/ˈʋnuː.t͡ʃik/
vnučka	/ˈʋnut͡ʃ.ka/
voda	/ˈvɔda/
vodca	/ˈʋɔt͡sːa/
vodík	/ˈvɔɟiːk/
vodič	/ˈvɔɟit͡ʃ/
vodiť	/ˈvɔɟic/
vodka	/ˈvɔtka/
vodopád	/ˈvɔdɔpaːt/
vôdzka	[ˈvʊ̯ɔtska]
vojak	/ˈvɔjak/
vojačik	/ˈvɔjat͡ʃik/
Vojtech	/ˈʋɔj.cex/
vôl	/ˈvu̯ɔɫ/
vola	/ˈvɔɫa/
volavka	/ˈvɔɫau̯ka/
volfrám	/ˈvɔɫfraːm/
volmi	[ˈvolmi]
voloch	[ˈvolox]
volom	[ˈvolom]
volov	/ˈvɔɫɔu̯/
volt	/ˈvɔɫt/
von	[von]
voz	/ˈvɔs/
voziť	/ˈvɔzic/
vôľa	/ˈvu̯ɔʎa/
voš	/ˈvɔʃ/
vplyv	/ˈfpɫiw/
vrabec	/ˈvrabɛt͡s/
vracať	/ˈvrat͡sac/
vrah	/ˈvrax/
vraj	/ˈvraj/
vrán	[vraːn]
vrana	/ˈvrana/
vrane	[ˈvrane]
vraní	/ˈvraɲiː/
vrany	[ˈvrani]
vrátane	/ˈvraːtanɛ/
vrátanie	[ˈvraːtani̯e]
Vratislav	/ˈvracisɫau̯/
vratič	[ˈvratit͡ʃ]
vrátiť	/ˈvraːcic/
Vratko	/ˈvratkɔ/
vravieť	/ˈvravi̯ɛc/
vražda	/ˈvraʒda/
vŕb	/ˈvr̩ːp/
vŕba	[ˈvr̩ːba]
vrch	/ˈʋr̩x/
vrece	/ˈvrɛt͡sɛ/
vrecko	/ˈvrɛt͡skɔ/
vretenica	/ˈvrɛcɛɲit͡sa/
vrh	/ˈʋr̩x/
vrkoč	/ˈvr̩kɔt͡ʃ/
Vroclav	/ˈʋrɔt͡s.ɫaw/
vrt	/ˈʋr̩t/
vrtuľník	/ˈvr̩tuʎɲiːk/
vrš	/ˈvr̩ʃ/
vŕš	/ˈvr̩ːʃ/
vrša	/ˈvr̩ʃa/
vstupenka	/ˈfstupɛŋka/
vták	/ˈftaːk/
vtákopysk	/ˈftaːkɔpisk/
vtáčik	/ˈftaːt͡ʃik/
vtedy	/ˈftɛdi/
vtĺcť	/ˈftɫ̩ːt͡sc/
vulkán	/ˈvuɫkaːn/
vuvuzela	/ˈʋu.ʋu.ze.ɫa/
vy	/Ëˆvi/
výbuch	/ˈviːbux/
vychádzka	/ˈvixaːt͡ska/
východ	/ˈviːxɔt/
Východný Timor	/ˈviːxɔdniː timɔr/
vydra	/ˈvidra/
vyhodnotiť	/ˈviɦɔdnɔcic/
výhovorka	[ˈviːɦovorka]
výnos	/ˈviːnɔs/
vypínať	/ˈvipiːnac/
vypnúť	/ˈvipnuːc/
výskum	/ˈviːskum/
výsledok	/ˈviːslɛdɔk/
vysoká škola	/ˈvisɔkaː ʃkɔɫa/
vysvedčenie	/ˈʋi.sʋet.t͡ʃe.ni̯e/
vývojka	/ˈviːvɔjka/
výťah	/ˈviːcax/
vzal	/ˈvzaɫ/
vzduch	/ˈvzdux/
vziať	/ˈvzi̯ac/
včela	/ˈft͡ʃɛɫa/
včera	/ˈft͡ʃɛra/
vďaka	/ˈvɟaka/
vďačnosť	/ˈvɟat͡ʃnɔsc/
vďačný	/ˈvɟat͡ʃniː/
všade	/ˈfʃaɟɛ/
všetci	/ˈfʃɛtt͡si/
všetok	/ˈfʃɛtɔk/
whisky	/ˈʋis.ki/
Wikipédia	/ˈvikipɛːdia/
Xénia	/ˈkseː.ni.a/
xénia	/ˈkseː.ni.a/
Xenofón	/ˈksɛnɔfɔːn/
xenón	[ˈksenoːn]
xylofón	/ˈksi.lɔ.fɔːn/
xylograf	/ˈksiɫɔɡraf/
Ý	/iː/
ý	/iː/
yeti	/ˈje.ti/
YMCA	[ˈimka]
ypsilon	/ˈipsiɫɔn/
yterbium	/ˈitɛrbium/
ytrium	/ˈit.ri.um/
yzop	/ˈizɔp/
-yňa	/iɲa/
z	/ˈz/
zabiť	/ˈzabic/
zabudnúť	/ˈzabudnuːc/
Zachariáš	/ˈzaxariaːʃ/
zachmúrený	/ˈzaxmuːrɛniː/
záhada	/ˈzaːɦada/
záhrada	/ˈzaːɦrada/
Záhreb	/ˈzaːɦrɛp/
zajac	/ˈzajat͡s/
zajačik	/ˈzajat͡ʃik/
zajtra	/ˈzaj.tra/
základná interakcia	/ˈzaːkladnaː intɛrakt͡sia/
základná číslovka	/ˈzaːkladnaː t͡ʃiːsɫɔu̯ka/
základný	/ˈzaːkɫadniː/
záležitosť	/ˈzaː.ɫe.ʒi.tɔsc/
zámeno	/ˈzaːmɛnɔ/
zámok	/ˈzaːmɔk/
zápal	/ˈzaːpaɫ/
zápcha	/ˈzaːpxa/
zapínať	/ˈzapiːnac/
zapnúť	/ˈzapnuːc/
zápražka	/ˈzaːpraʃka/
zásaditý	/ˈzaː.sa.ɟi.tiː/
zaspať	[ˈzaspac]
zastaralý	/ˈzastaraɫiː/
zatiaľ	/ˈzaci̯aʎ/
hlave	[ˈɦlave]
denne	[ˈdene]
hora	[ˈɦora]
nosoch	[ˈnosox]
nosmi	[ˈnosmi]
koláčik	[ˈkolaːt͡ʃik]
koláčom	[ˈkolaːt͡ʃom]
koláču	[ˈkolaːt͡ʃu]
koláči	[ˈkolaːt͡ʃi]
koláča	[ˈkolaːt͡ʃa]
darovať	[ˈdarovac]
zaspať	[ˈzaspac]
na zdravie	[na zdravi̯e]
cestovať	[ˈt͡sestovac]
palec na nohe	[palet͡s na noɦe]
pieh	[pi̯ex]
pehy	[ˈpeɦi]
pehách	[ˈpeɦaːx]
pehám	[ˈpeɦaːm]
pohára	[ˈpoɦaːra]
zátvorka	/ˈzaːtvɔrka/
závisť	/ˈzaː.ʋisc/
zázrak	/ˈzaː.zrak/
zázračný	/ˈzaːzrat͡ʃniː/
zázvor	/ˈzaːzvɔr/
začať	/ˈzat͡ʃac/
začiatok	/ˈzat͡ʃi̯atɔk/
zať	/ˈzac/
zažať	/ˈzaʒac/
zbohom	/ˈzbɔɦɔm/
zboží	/ˈzbɔʒiː/
zbožie	/ˈzbɔʒi̯ɛ/
Zdenka	/ˈzɟɛŋka/
zdraví	/ˈzdraviː/
zdravie	/ˈzdravi̯ɛ/
zdravý	/ˈzdraviː/
zdrobnenina	/ˈzdrɔbɲɛɲina/
zelená	/ˈzɛlɛnaː/
zelenina	/ˈzɛlɛɲina/
zelený	/ˈze̞.ɫe̞.niː/
zem	/ˈzɛm/
zemepis	/ˈzɛmɛpis/
zemetrasenie	/ˈzɛmɛtrasɛɲi̯ɛ/
zemi	/ˈzemi/
zemí	/ˈzɛmiː/
zemiak	/ˈzɛmi̯ak/
zemiakový	/ˈzɛmi̯akɔviː/
zemiaky	/ˈzɛmi̯aki/
Zeus	/ˈze̞.us/
zhodnotiť	/ˈzɦɔdnɔcic/
zima	/ˈzima/
zime	[ˈzime]
zimu	[ˈzimu]
Zina	/ˈzina/
Zlatica	/ˈzɫacit͡sa/
Zlatko	/ˈzɫatkɔ/
zlato	/ˈzɫatɔ/
zlatý	/ˈzɫa.tiː/
zlí	/ˈzɫiː/
zlo	/ˈzɫɔ/
Zloch	[zlox]
Zlocha	[ˈzloxa]
Zlochová	[ˈzloxovaː]
zlodej	/ˈzɫɔɟɛj/
zlý	/ˈzɫiː/
zmena	/ˈzmɛna/
zmes	/ˈzmɛs/
zmija	/ˈzmija/
zmluva	/ˈzmɫuva/
zmrd	/ˈzmr̩t/
zmrzlina	/ˈzmr̩z.ɫi.na/
znamenať	/ˈznamɛnac/
znať	/ˈznac/
znezrady	/ˈzɲɛzradi/
zo	/ˈzɔ/
zobáčik	/ˈzɔbaːt͡ʃik/
Zoja	/ˈzɔja/
Zoltán	/ˈzɔɫtaːn/
zolvica	[ˈzolvit͡sa]
zombi	/ˈzɔmbi/
zombia	/ˈzɔmbia/
zombie	[ˈzombi̯e]
zomrieť	/ˈzɔmri̯ɛc/
zoológia	/ˈzɔɔɫɔːɡia/
zoom	/zuːm/
Zora	/ˈzɔra/
zoznam	/ˈzɔznam/
zrak	/ˈzrak/
zrelý	/ˈzrɛliː/
zrenica	/ˈzrɛɲit͡sa/
zrkadlo	/ˈzr̩kadɫɔ/
zŕn	/ˈzr̩ːn/
zrniečko	/ˈzr̩ɲi̯ɛt͡ʃkɔ/
zrno	/ˈzr̩.no̞/
zröntgenovať	/ˈzrɛntɡɛnɔvac/
zub	/ˈzup/
zuba	[Ëˆzuba]
zubár	/ˈzubaːr/
zubáč	/ˈzubaːt͡ʃ/
zunovaný	/ˈzunɔvaniː/
zunovať	/ˈzunɔvac/
Zuzana	/ˈzuzana/
Zuzanka	/ˈzuzaŋka/
Zuzka	/ˈzuska/
zväz	/ˈzʋes/
Zväz sovietskych socialistických republík	/ˈzvɛs sɔvi̯ɛtskix sot͡sialistit͡skiːx rɛpubliːk/
zviera	/ˈzvi̯ɛra/
zvuk	/ˈzvuk/
zvýšiť	/ˈzviːʃic/
zvyšný	/ˈzviʃniː/
zvyšok	/ˈzviʃɔk/
zľava	/ˈzʎava/
Ålandy	/ˈɔɫandi/
ångström	/ˈankstrem/
č	/t͡ʃ/
Čad	/ˈt͡ʃat/
čaj	/ˈt͡ʃaj/
čajka	/ˈt͡ʃajka/
čajovňa	[ˈt͡ʃajovɲa]
čakať	/ˈt͡ʃakac/
čaro	/ˈt͡ʃarɔ/
čas	/ˈt͡ʃas/
časti	/ˈt͡ʃasci/
častí	/ˈt͡ʃasciː/
častica	/ˈt͡ʃascit͡sa/
časť	/ˈt͡ʃasc/
čau	/ˈt͡ʃau̯/
čaša	/ˈt͡ʃaʃa/
Čech	/ˈt͡ʃɛx/
čechizmus	/ˈt͡ʃɛxizmus/
Čechy	/ˈt͡ʃɛxi/
čej	/ˈt͡ʃɛj/
čelo	/ˈt͡ʃɛɫɔ/
čerešňa	/ˈt͡ʃɛrɛʃɲa/
černica	/ˈt͡ʃɛrɲit͡sa/
černoch	/ˈt͡ʃɛrnɔx/
červ	/ˈt͡ʃɛrw/
červený	/ˈt͡ʃɛrvɛniː/
Česko	/ˈt͡ʃɛskɔ/
Československo	/ˈt͡ʃɛskɔsɫɔvɛnskɔ/
český	/ˈt͡ʃes.kiː/
česť	/ˈt͡ʃɛsc/
Čečensko	/ˈt͡ʃe.t͡ʃen.skɔ/
čečenský	/ˈt͡ʃɛt͡ʃɛnskiː/
čeština	/ˈt͡ʃɛʃcina/
či	/ˈt͡ʃi/
čiapka	/ˈt͡ʃi̯apka/
čiapočka	/ˈt͡ʃi̯apɔt͡ʃka/
čiaročka	/ˈt͡ʃi̯arɔt͡ʃka/
čierna	[ˈt͡ʃi̯erna]
čierna diera	/ˈt͡ʃi̯ɛrna ɟi̯ɛra/
Čierna Hora	/ˈt͡ʃi̯ɛrna ɦɔra/
čierne korenie	/ˈt͡ʃi̯ɛrnɛ ˌkɔrɛɲi̯ɛ/
Čierne more	/ˈt͡ʃi̯ɛrnɛ mɔrɛ/
čierny	/ˈt͡ʃi̯er.ni/
čím	/ˈt͡ʃiːm/
čin	/ˈt͡ʃin/
Čína	/ˈt͡ʃiːna/
činnosť	/ˈt͡ʃinnɔsc/
čínsky	/ˈt͡ʃiːnski/
čipka	/ˈt͡ʃipka/
číselný	/ˈt͡ʃiːsɛɫniː/
číslo	/ˈt͡ʃiːsɫɔ/
číslovka	/ˈt͡ʃiːsɫɔu̯ka/
číslovky	/ˈt͡ʃiːsɫɔu̯ki/
čistej	/ˈt͡ʃiscɛj/
čistý	/ˈt͡ʃistiː/
čítať	/ˈt͡ʃiː.tac/
čivava	/ˈt͡ʃivava/
Číňan	/ˈt͡ʃiːɲan/
Číňanka	/ˈt͡ʃiːɲaŋka/
čiže	/ˈt͡ʃiʒɛ/
čižma	/ˈt͡ʃiʒ.ma/
čižmička	/ˈt͡ʃiʒmit͡ʃka/
členok	/ˈt͡ʃlɛnɔk/
čln	/ˈt͡ʃɫ̩n/
človek	/ˈt͡ʃɫɔvɛk/
človiečik	/ˈt͡ʃɫɔvi̯ɛt͡ʃik/
čmeľ	/ˈt͡ʃmɛʎ/
čo	/ˈt͡ʃɔ/
čokoláda	/ˈt͡ʃɔkɔɫaːda/
čomu	/ˈt͡ʃɔmu/
čoskoro	/ˈt͡ʃɔskɔrɔ/
čpavok	/ˈt͡ʃpavɔk/
čremcha	[ˈt͡ʃremxa]
črep	/ˈt͡ʃrɛp/
črevo	/ˈt͡ʃrɛvɔ/
	
čŕt	/ˈt͡ʃr̩ːt/
črta	/ˈt͡ʃr̩ta/
ČSSR	/ˈt͡ʃɛː ɛs ɛs ɛr/
čuch	[t͡ʃux]
čuchať	/ˈt͡ʃuxac/
čudný	/ˈt͡ʃudniː/
čujný	/ˈt͡ʃujniː/
čučoriedka	/ˈt͡ʃut͡ʃɔri̯ɛtka/
ďakovať	[ˈɟakovac]
ďakujúci	/ˈɟakujuːt͡si/
ďalekohľad	/ˈɟalɛkɔɦʎat/
ďalší	/ˈɟaɫʃiː/
ďasno	[ˈɟasno]
ďatelina	/ˈɟacɛlina/
ďateľ	/ˈɟacɛʎ/
ľad	/ˈʎat/
ľadnička	/ˈʎadɲit͡ʃka/
ľadoborec	/ˈʎadɔbɔrɛt͡s/
ľadvina	/ˈʎadvina/
ľahký	/ˈʎaxkiː/
ľstivý	/ˈʎsciviː/
Ľuba	/ˈʎuba/
Ľubica	/ˈʎubit͡sa/
ľúbim ťa	[ʎuːbim ca]
Ľubo	/ˈʎubɔ/
Ľubomír	/ˈʎubɔmiːr/
Ľubomíra	/ˈʎubɔmiːra/
Ľubor	/ˈʎubɔr/
Ľuboslav	/ˈʎubɔsɫau̯/
Ľuboslava	/ˈʎubɔsɫava/
Ľuboš	/ˈʎubɔʃ/
Ľubľana	/ˈlʲu.blʲa.na/
hlave	[ˈɦlave]
denne	[ˈdene]
hora	[ˈɦora]
nosoch	[ˈnosox]
nosmi	[ˈnosmi]
koláčik	[ˈkolaːt͡ʃik]
koláčom	[ˈkolaːt͡ʃom]
koláču	[ˈkolaːt͡ʃu]
koláči	[ˈkolaːt͡ʃi]
koláča	[ˈkolaːt͡ʃa]
darovať	[ˈdarovac]
zaspať	[ˈzaspac]
na zdravie	[na zdravi̯e]
cestovať	[ˈt͡sestovac]
palec na nohe	[palet͡s na noɦe]
pieh	[pi̯ex]
pehy	[ˈpeɦi]
pehách	[ˈpeɦaːx]
pehám	[ˈpeɦaːm]
pohára	[ˈpoɦaːra]
Ľuda	/ˈʎuda/
ľudia	/ˈʎuɟi̯a/
Ľudmila	/ˈʎudmiɫa/
Ľudo	/ˈʎudɔ/
Ľudomil	/ˈʎudɔmiɫ/
Ľudomila	/ˈʎudɔmiɫa/
Ľudovít	/ˈʎudɔviːt/
ň	/ɲ/
ňom	[ɲom]
ňu	[ɲu]
šach	/ˈʃax/
šach-mat	/ˈʃaxmat/
šachovnica	/ˈʃaxɔu̯ɲit͡sa/
šakal	/ˈʃakaɫ/
šálka	/ˈʃaːɫka/
šáločka	/ˈʃaɫɔt͡ʃka/
šamlík	/ˈʃamliːk/
šampión	/ˈʃam.pi.ɔːn/
šatka	/ˈʃatka/
šatôčka	/ˈʃatu̯ɔt͡ʃka/
šaty	/ˈʃati/
šestnásť	/ˈʃɛstnaːsc/
šesť	/ˈʃɛst/
šiesty	/ˈʃi̯ɛsti/
šija	/ˈʃi.ja/
šimpanz	/ˈʃimpans/
šíp	/ˈʃiːp/
šípka	/ˈʃiːpka/
šiška	/ˈʃiʃka/
škál	/ˈʃkaːɫ/
škála	/ˈʃkaːɫa/
škandál	/ˈʃkandaːɫ/
Škandinávia	/ˈʃkandinaːvia/
Škandinávie	/ˈʃkandinaːviɛ/
škáročka	/ˈʃkaːrɔt͡ʃka/
škatuľa	/ˈʃkatuʎa/
škoda	/ˈʃkɔda/
škola	/ˈʃkɔɫa/
škorec	/ˈʃkɔrɛt͡s/
škorica	/ˈʃkɔrit͡sa/
škorpión	/ˈʃkɔrpiɔːn/
škorčí	/ˈʃkɔrt͡ʃiː/
Škót	/ˈʃkɔːt/
Škóti	/ˈʃkɔːci/
Škótsko	/ˈʃkɔːtskɔ/
škótsky	/ˈʃkɔːtski/
škótština	/ˈʃkɔːtʃcina/
škovránok	/ˈʃkɔvraːnɔk/
škrečok	/ˈʃkrɛt͡ʃɔk/
škriabať	/ˈʃkri̯abac/
škrt	/ˈʃkr̩t/
škrupina	/ˈʃkrupina/
škrupinka	/ˈʃkrupiŋka/
škvŕn	/ˈʃkvr̩ːn/
škvrna	/ˈʃkvr̩.na/
šmrnc	/ˈʃmr̩nt͡s/
šofér	/ˈʃɔfɛːr/
šoférka	[ˈʃofeːrka]
šoférovať	[ˈʃofeːrovac]
šoférsky preukaz	/ˈʃɔfɛːrski preu̯kas/
šógun	/ˈʃɔːɡun/
šok	/ˈʃɔk/
Šopron	/ˈʃɔprɔn/
šou	/ˈʃɔw/
šošovica	/ˈʃɔʃɔvit͡sa/
šošovka	/ˈʃɔʃɔu̯ka/
špageta	/ˈʃpaɡɛta/
špagety	/ˈʃpaɡɛti/
Španielsko	/ˈʃpaɲi̯ɛɫskɔ/
španielčina	/ˈʃpaɲi̯ɛɫt͡ʃina/
špeciálna pedagogika	/ˈʃpet͡siaːɫna pɛdaɡɔɡika/
špekulácia	/ˈʃpe.ku.ɫaː.t͡si.a/
špenát	/ˈʃpɛnaːt/
Špicbergy	/ˈʃpit͡sbɛrɡi/
šplh	/ˈʃpɫ̩x/
šprt	/ˈʃpr̩t/
štart	/ʃtart/
štát	/ˈʃtaːt/
štátny	/ˈʃtaːtni/
Štefan	/ˈʃcɛfan/
Štefánia	/ˈʃcɛfaːnia/
štetka na holenie	[ʃtetka na ɦoleni̯e]
-ština	[ˈʃtina]
štiny	/ˈʃcini/
štít	[ʃtiːt]
štóla	/ˈʃtɔː.ɫa/
štopeľ	/ˈʃtɔpɛʎ/
štrajk	/ˈʃtrajk/
štrajkovať	/ˈʃtrajkɔvac/
štrk	/ˈʃtr̩k/
štrkáč	/ˈʃtr̩kaːt͡ʃ/
štrnásť	/ˈʃtr̩naːsc/
študent	/ˈʃtudɛnt/
štvrtok	/ˈʃtvr̩tɔk/
štvrtý	/ˈʃtvr̩tiː/
štvrť	[ʃtvr̩c]
štyri	/ˈʃtiri/
štyridsať	/ˈʃtirit͡sac/
šuškovité teliesko	/ˈʃuʃkɔvitɛː cɛli̯ɛskɔ/
švagor	/ˈʃvaɡɔr/
Švajčiarsko	/ˈʃvajt͡ʃi̯arskɔ/
Švéd	/ˈʃʋeːt/
Švédka	/ˈʃʋeːt.ka/
Švédsko	/ˈʃvɛːtskɔ/
švédsky	/ˈʃvɛːtski/
švédčina	/ˈʃvɛːtt͡ʃina/
šľachtic	/ˈʃʎaxcit͡s/
šťastie	[ˈʃcasci̯e]
šťuka	[ˈʃcuka]
šťúr	/ˈʃcuːr/
-ť	/c/
ťa	[ca]
ťarchavý	/ˈcarxaviː/
ťava	/ˈcava/
ťažký	/ˈcaʃ.kiː/
ž	/ʒ/
žaba	/ˈʒaba/
Žalmy	/ˈʒaɫmi/
žalúdok	/ˈʒaɫuːdɔk/
Žaneta	/ˈʒanɛta/
žať	/ˈʒac/
žbŕnd	/ˈʒbr̩ːnt/
žbrnda	/ˈʒbr̩n.da/
že	/ʒɛ/
želanie	/ˈʒɛɫaɲi̯ɛ/
želať	/ˈʒɛɫac/
železo	/ˈʒe.ɫe.zɔ/
Želmíra	/ˈʒɛɫmiːra/
žemlička	/ˈʒɛmlit͡ʃka/
žemľa	/ˈʒɛmʎa/
žena	/ˈʒe.na/
ženách	/ˈʒɛnaːx/
ženám	/ˈʒɛnaːm/
ženami	/ˈʒɛnami/
ženatý	/ˈʒɛnatiː/
žene	/ˈʒɛɲɛ/
ženou	/ˈʒenɔu̯/
ženu	/ˈʒenu/
ženy	/ˈʒeni/
žeriav	/ˈʒɛri̯au̯/
žerucha	/ˈʒɛruxa/
žerušnica krivolaká	/ˈʒɛrʊʃɲɪt͡sa ˈkrɪvɔlakaː/
žgrloš	/ˈʒɡr̩ɫɔs/
žiak	/ˈʒi̯ak/
Žiak	/ˈʒi̯ak/
žiačik	/ˈʒi̯at͡ʃik/
Žiačik	/ˈʒi̯at͡ʃik/
Žiačík	/ˈʒi̯at͡ʃiːk/
žid	/ˈʒit/
Žid	/ˈʒit/
žien	/ˈʒi̯en/
Žigmund	/ˈʒiɡmund/
žihľava	/ˈʒiɦʎava/
žihľavka	/ˈʒiɦʎau̯ka/
žila	/ˈʒiɫa/
Žila	/ˈʒiɫa/
Žíla	/ˈʒiːɫa/
žiletka	/ˈʒilɛtka/
Žilina	[ˈʒilina]
žinčica	/ˈʒint͡ʃit͡sa/
žirafa	/ˈʒirafa/
žirafí	/ˈʒirafiː/
	
životopis	/ˈʒivɔtɔpis/
živočích	/ˈʒivɔt͡ʃiːx/
živý	/ˈʒiviː/
žízeň	/ˈʒiːzɛɲ/
žičiť	/ˈʒit͡ʃic/
žiť	/ˈʒic/
žlna	/ˈʒɫ̩na/
žĺtkový	/ˈʒɫ̩ːtkɔviː/
žĺtok	/ˈʒɫ̩ː.tɔk/
žltý	/ˈʒɫ̩tiː/
žlč	[ʒl̩t͡ʃ]
žlť	/ˈʒɫ̩t/
žmýkačka	/ˈʒmiːkat͡ʃka/
žni	/ˈʒɲi/
Žofia	/ˈʒɔfia/
žreb	/ˈʒrɛp/
žriebä	/ˈʒri̯e.be/
žriebäcí	/ˈʒri̯bɛt͡siː/
žrď	/ˈʒr̩c/
žubrienka	/ˈʒubri̯ɛŋka/
žurnál	/ˈʒur.naːɫ/
žurnalista	/ˈʒurnalista/
žurnalistika	/ˈʒur.na.lis.ti.ka/
žurnalistka	[ˈʒurnalistka]
žuvačka	/ˈʒuvat͡ʃka/
žuvať	/ˈʒuvac/
