klobučár	/klɔbut͡ʃàːr/
rẹ̑d	/réːt/
do	/dÉ”/
vratȉč	/ʋratít͡ʃ/
otáva	/ɔtàːʋa/
slȁb	/sláp/
zgréšiti	/zɡrɛ̀ːʃiti/
vółga	/ʋɔ̀ːʋɡa/
čẹ́maž	/t͡ʃèːmaʃ/
se	/sɛ/
nẹ́mško	/nèːmʃkɔ/
odrešeník	/ɔdrɛʃɛnìːk/
gáms	/ɡàːms/
lẹ́šnik	/lèːʃnik/
vọ̑jvodina	/ʋóːjʋɔdina/
mīrna Bọ̑sna	/mìːrna bóːsna/
dóbro jútro	/dɔ̀ːbrɔ jùːtrɔ/
diják	/dijàːk/
podgána	/pɔdɡàːna/
medeníca	/mɛdɛnìːt͡sa/
ȃbak	/áːbak/
abecẹ̑da	/abɛt͡séːda/
absolȗtna nȋčla	/apsɔlúːtna níːt͡ʃla/
abstrȃktən	/apstráːktən/
abstrȃktno	/apstráːktnɔ/
absȗrdən	/apsúːrdən/
absȗrdnejši	/apsúːrdnɛjʃi/
acetọ̑n	/at͡sɛtóːn/
adȋjo	/adíːjɔ/
adjektȋvən	/adjɛktíːʋən/
adȗt	/adúːt/
ȃerodinámika	/áːɛrɔdinàːmika/
aerolȋt	/aɛrɔlíːt/
Afgȃnistan	/aʋɡáːnistan/
áfna	/àːfna/
Ȃfrika	/áːfrika/
aglomerácija	/aɡlɔmɛràːt͡sija/
agrȗmi	/aɡrúːmi/
Ahȋl	/axíːl/
ahọ̑j	/axóːj/
ȁjd	/ájt/
ȃjnštajnij	/áːjnʃtajnij/
aksiọ̑m	/aksijóːm/
aktínij	/aktìːnij/
aktualizácija	/aktualizàːt͡sija/
aktualizȋrati	/aktualizíːrati/
ȃkuzativ	/áːkuzatiʋ/
akvárij	/akʋàːrij/
Albȃnəc	/albáːnət͡s/
Albánija	/albàːnija/
Albȃnka	/albáːnka/
albȃnski	/albáːnski/
albȃnsko	/albáːnskɔ/
albȃnščina	/albáːnʃt͡ʃina/
Aleksándər	/alɛksàːndər/
Aleksándər Vẹ̑liki	/alɛksàːndər ʋéːliki/
ȁli	/áli/
aligȃtor	/aliɡáːtɔr/
Aljȃska	/aljáːska/
alkohọ̑l	/alkɔxóːl/
alpȃka	/alpáːka/
alumínij	/alumìːnij/
Alžȋrija	/alʒíːrija/
Ȃman	/áːman/
amarānt	/amaràːnt/
ambasȃdor	/ambasáːdɔr/
ambrọ́zija	/ambròːzija/
amerícij	/amɛrìːt͡sij/
Amȇrika	/amɛ́ːrika/
amȇriški	/amɛ́ːriʃki/
amfiteátər	/amfitɛàːtər/
ȁmpak	/ámpak/
ampȇr	/ampɛ́ːr/
amputȋrati	/amputíːrati/
amulẹ̑t	/amuléːt/
Ána	/àːna/
anakọ̑nda	/anakóːnda/
anȃlən	/anáːlən/
anȃlni sẹ̑ks	/anáːlni séːks/
analogȋja	/analɔɡíːja/
ȃnanas	/áːnanas/
anarhȋst	/anarxíːst/
anarhízəm	/anarxìːzəm/
anatomȋja	/anatɔmíːja/
Andalúzija	/andalùːzija/
Andọ̑ra	/andóːra/
Andreáš	/andrɛàːʃ/
Andréj	/andrɛ̀ːj/
ángel	/àːnɡɛl/
anglẹ̑ščina	/anɡléːʃt͡ʃina/
anglẹ̑ški	/anɡléːʃki/
anglẹ̑ško	/anɡléːʃkɔ/
Anglẹ̑ž	/anɡléːʃ/
Anglẹ̑žinja	/anɡléːʒinja/
Ȃnglija	/áːnɡlija/
anomalȋja	/anɔmalíːja/
Antárktika	/antàːrktika/
antilọ̑pa	/antilóːpa/
antimọ̑n	/antimóːn/
Antọ̑n	/antóːn/
antonȋm	/antɔníːm/
apartmȃ	/apartmáː/
apnẹ̄nəc	/apnèːnət͡s/
apokalȋpsa	/apɔkalíːpsa/
apostrọ̑f	/apɔstróːf/
aprȋl	/apríːl/
arȃbski	/aráːpski/
aragonȋt	/araɡɔníːt/
arašȋd	/araʃíːt/
argọ̑n	/áːrɡɔn/
Ȃrh	/áːrx/
arhitektȗra	/arxitɛktúːra/
arhivár	/arxiʋàːr/
Aristọ̑tel	/aristóːtɛl/
armȃda	/armáːda/
Armẹ́nija	/armèːnija/
artefȃkt	/artɛfáːkt/
artérija	/artɛ̀ːrija/
arzẹ̑n	/arzéːn/
ȃs	/áːs/
ȁsimetrȋja	/ásimɛtríːja/
Asklẹ́pij	/asklèːpij/
astȃt	/astáːt/
asteroȋd	/astɛrɔíːt/
ȃstrofízika	/áːstrɔfìːzika/
astrologȋja	/astrɔlɔɡíːja/
astronomȋja	/astrɔnɔmíːja/
ateízəm	/atɛìːzəm/
Atẹ̑na	/atéːna/
Atẹ̑ne	/atéːnɛ/
-ati	/-ati/
atọ̑l	/atóːl/
atọ̑mski	/atóːmski/
ȁtonȃlən	/átɔnáːlən/
átrij	/àːtrij/
-ȃvati	/-áːʋati/
avgȗst	/aʋɡúːst/
Avstrálija	/aʋstràːlija/
Ȃvstrija	/áːʋstrija/
Avstrȋjəc	/aʋstríːjət͡s/
Avstrȋjka	/aʋstríːjka/
avstrȋjski	/aʋstríːjski/
Ȃvstro-Ọ̑grska	/áːʋstrɔ-óːɡərska/
ȃvto	/áːʋtɔ/
ȃvtobus	/áːʋtɔbus/
ȃvtosugestȋja	/áːʋtɔsuɡɛstíːja/
Azerbajdžȃn	/azɛrbajd͡ʒáːn/
Ázija	/àːzija/
azȋl	/azíːl/
b	/bə́/
bába	/bàːba/
bábica	/bàːbit͡sa/
bágər	/bàːɡər/
bagrȋst	/baɡríːst/
Bahȃmi	/baxáːmi/
Bahrȃjn	/baxráːjn/
bajonẹ̑t	/bajɔnéːt/
bȃjta	/báːjta/
bákər	/bàːkər/
bȃkla	/báːkla/
balẹ̑t	/baléːt/
Bȃltsko mọ̑rje	/báːltskɔ móːrjɛ/
bȃmbus	/báːmbus/
bánja	/bàːnja/
bȃnka	/báːnka/
barantáti	/barantàːti/
bárij	/bàːrij/
bȃrion	/báːrijɔn/
bȃrka	/báːrka/
bȃrva	/báːrʋa/
bȃrvna lẹ́stvica	/báːrʋna lèːstʋit͡sa/
bȃs	/báːs/
básati	/bàːsati/
Bȃsk	/báːsk/
bȃskovski	/báːskɔʋski/
bȃskovščina	/báːskɔʋʃt͡ʃina/
baterȋja	/batɛríːja/
báti	/bàːti/
batiskȃf	/batiskáːf/
bāza	/bàːza/
bazȃlt	/bazáːlt/
bẹ̑	[beː]
bẹ́da	/bèːda/
bedák	/bɛdàːk/
bẹ́dən	/bèːdən/
bẹ́dnejši	/bèːdnɛjʃi/
bédro	/bɛ̀ːdrɔ/
bẹ̑g	/béːk/
begȗnəc	/bɛɡúːnət͡s/
bẹ́ł	/bèːʋ/
bẹ́la pritlíkavka	/bèːla pritlìːkaʋka/
belȇjši	/bɛlɛ́ːjʃi/
Bẹ́lgija	/bèːlɡija/
bẹ́lgijski	/bèːlɡijski/
belína	/bɛlìːna/
belják	/bɛljàːk/
Belorȗsija	/bɛlɔrúːsija/
belorȗski	/bɛlɔrúːski/
belorȗščina	/bɛlɔrúːʃt͡ʃina/
Benẹ̑tke	/bɛnéːtkɛ/
benzẹ̑n	/bɛnzéːn/
Bẹ̑ograd	/béːɔɡrat/
bẹ̑rgla	/béːrɡla/
berílij	/bɛrìːlij/
berkẹ́lij	/bɛrkèːlij/
besẹ̑da	/bɛséːda/
besẹ̑dən	/bɛséːdən/
besedílo	/bɛsɛdìːlɔ/
besedotvọ̄rən	/bɛsɛdɔtʋòːrən/
besedotvọ̑rje	/bɛsɛdɔtʋóːrjɛ/
betẹ́žən	/bɛtèːʒən/
betẹ́žnejši	/bɛtèːʒnɛjʃi/
Bẹ̑tlehem	/béːtlɛxɛm/
betọ̑n	/bɛtóːn/
bəzə̏g	/bəzə́k/
bezjȃk	/bɛzjáːk/
bežáti	/bɛʒàːti/
bīč	/bìːt͡ʃ/
bȉk	/bík/
binọ̑m	/binóːm/
klobučár	/klɔbut͡ʃàːr/
rẹ̑d	/réːt/
do	/dÉ”/
vratȉč	/ʋratít͡ʃ/
otáva	/ɔtàːʋa/
slȁb	/sláp/
zgréšiti	/zɡrɛ̀ːʃiti/
vółga	/ʋɔ̀ːʋɡa/
čẹ́maž	/t͡ʃèːmaʃ/
se	/sɛ/
odrešeník	/ɔdrɛʃɛnìːk/
gáms	/ɡàːms/
lẹ́šnik	/lèːʃnik/
vọ̑jvodina	/ʋóːjʋɔdina/
mīrna Bọ̑sna	/mìːrna bóːsna/
dóbro jútro	/dɔ̀ːbrɔ jùːtrɔ/
diják	/dijàːk/
podgána	/pɔdɡàːna/
medeníca	/mɛdɛnìːt͡sa/
kẹ́lih	/kèːlix/
bȋokemȋja	/bíːjɔkɛmíːja/
biolọ̑ški	/biɔlóːʃki/
birtȋja	/birtíːja/
bisāga	/bisàːɡa/
bȋseksuȃlnost	/bíːsɛksuáːlnɔst/
bȋser	/bíːsɛr/
bȋstvo	/bíːstʋɔ/
bíti	/bìːti/
bītje	/bìːtjɛ/
bȋvol	/bíːʋɔl/
bȋvši	/bíːʋʃi/
bizantȋnski	/bizantíːnski/
bȋzgəc	/bíːzɡət͡s/
bȋzmut	/bíːzmut/
bȋzon	/bíːzɔn/
blȃg	/bláːk/
blagȃjna	/blaɡáːjna/
blagọ̑	/blaɡóː/
blagoslovīti	/blaɡɔslɔʋìːti/
Blȃtnik	/bláːtnik/
bláto	/blàːtɔ/
blázən	/blàːzən/
Blȃznik	/bláːznik/
blestẹ́ti	/blɛstèːti/
blésti	/blɛ̀ːsti/
blízu	/blìːzu/
blȋže	/blíːʒɛ/
blȋžje	/blíːʒjɛ/
blȋžnjica	/blíːʒnjit͡sa/
bọ̑	/bóː/
bọ̑bən	/bóːbən/
bọ́bər	/bòːbər/
bọ́di	/bòːdi/
bọ́dimo	/bòːdimɔ/
bọ́dita	/bòːdita/
bọ́dite	/bòːditɛ/
bọ́diva	/bòːdiʋa/
bọ̑do	/bóːdɔ/
bọ̑g	/bóːk/
Bọ̑g	/bóːk/
bogȃstvo	/bɔɡáːstʋɔ/
bogȁt	/bɔɡát/
bogatȇjši	/bɔɡatɛ́ːjʃi/
bogínja	/bɔɡìːnja/
bogomọ̑lka	/bɔɡɔmóːlka/
bọ̑ja	/bóːja/
bojȃzən	/bɔjáːzən/
bọ̑jo	/bóːjɔ/
bokȃł	/bɔkáːʋ/
bolȃn	/bɔláːn/
bolečína	/bɔlɛt͡ʃìːna/
bolẹ́ti	/bɔlèːti/
bolẹ̑zən	/bɔléːzən/
Bolgȃr	/bɔlɡáːr/
Bolgárija	/bɔlɡàːrija/
Bolgȃrka	/bɔlɡáːrka/
bolgārski	/bɔlɡàːrski/
bolgārsko	/bɔlɡàːrskɔ/
bolgārščina	/bɔlɡàːrʃt͡ʃina/
bółha	/bɔ̀ːʋxa/
bȍlj	/bɔ́l/
bọ̑lje	/bóːljɛ/
bọ̑ljše	/bóːlʃɛ/
bọ̑ljši	/bóːlʃi/
bọ̑lnica	/bóːlnit͡sa/
bołník	/bɔʋnìːk/
bołnȋšnica	/bɔʋníːʃnit͡sa/
bọ̑m	/bóːm/
bọ̑mba	/bóːmba/
bombardȋrati	/bɔmbardíːrati/
bombȃž	/bɔmbáːʃ/
bọ̑mbnik	/bóːmbnik/
bọ̑mo	/bóːmɔ/
bọ̑n	/bóːn/
bȍr	/bɔ́r/
bọ̑rba	/bóːrba/
bọ̑rəc	/bóːrət͡s/
borīti	/bɔrìːti/
bọ̄rka	/bòːrka/
borovníca	/bɔrɔʋnìːt͡sa/
bọ̑rša	/bóːrʃa/
bọ̑rza	/bóːrza/
bȍs	/bóːs/
bosānski	/bɔsàːnski/
bosānščina	/bɔsàːnʃt͡ʃina/
bọ̑sənski	/bóːsənski/
Bọ̑sna	/bóːsna/
Bọ̑sna in Hercegovína	/bóːsna in xɛrt͡sɛɡɔʋìːna/
bọ̑sta	/bóːsta/
bọ̑ste	/bóːstɛ/
bósti	/bɔ̀ːsti/
bọ̑š	/bóːʃ/
bọ̑va	/bóːʋa/
bozọ̑n	/bɔzóːn/
božȃnski	/bɔʒáːnski/
božȃnstvo	/bɔʒáːnstʋɔ/
bọ̑žati	/bóːʒati/
Bóžič	/bɔ̀ːʒit͡ʃ/
božūr	/bɔʒùːr/
bráda	/bràːda/
bradȁt	/bradát/
bradátejši	/bradàːtɛjʃi/
bradavíca	/bradaʋìːt͡sa/
brȃlnik	/bráːlnik/
brȃn	/bráːn/
brána	/bràːna/
braník	/branìːk/
branīti	/branìːti/
brȁt	/brát/
bráti	/bràːti/
brátranəc	/bràːtranət͡s/
brázda	/bràːzda/
brazgotína	/brazɡɔtìːna/
Brazílija	/brazìːlija/
brazȋlski	/brazíːlski/
bȓca	/bə́rt͡sa/
bŕcniti	/bə̀rt͡sniti/
brdȃvs	/bərdáːʋs/
bŕdo	/bə̀rdɔ/
brẹ̑g	/bréːk/
brẹ̑skəv	/bréːskəʋ/
brẹ̄st	/brèːst/
brésti	/brɛ̀ːsti/
Bretánja	/brɛtàːnja/
Bretọ̑nəc	/brɛtóːnət͡s/
Bretọ̑nka	/brɛtóːnka/
bretọ̑nski	/brɛtóːnski/
bretọ̑nsko	/brɛtóːnskɔ/
bretọ̑nščina	/brɛtóːnʃt͡ʃina/
brez	/brɛs/
brẹ́za	/brèːza/
brezčȗstven	/brɛst͡ʃúːstʋɛn/
brezosẹ̑bən	/brɛzɔséːbən/
brȋga	/bríːɡa/
bríhtən	/brìːxtən/
bríhtnejši	/brìːxtnɛjʃi/
brȉn	/brín/
Británija	/britàːnija/
Britȃnska Kolúmbija	/britáːnska kɔlùːmbija/
britȃnski	/britáːnski/
brȋvəc	/bríːʋət͡s/
bȓki	/bə́rki/
brlȍg	/bərlɔ́k/
brọ̑d	/bróːt/
brọ̑m	/bróːm/
brȍn	/brɔ́n/
brȗsnica	/brúːsnit͡sa/
brȗto	/brúːtɔ/
bȓv	/bə́rʋ/
búča	/bùːt͡ʃa/
Bȗda	/búːda/
budálo	/budàːlɔ/
búdən	/bùːdən/
Bȗdimpešta	/búːdimpɛʃta/
bȗkəv	/búːkəʋ/
búksəlj	/bùːksəl/
bȗnda	/búːnda/
bȗrek	/búːrɛk/
butȃn	/butáːn/
bútara	/bùːtara/
cār	/t͡sàːr/
caríca	/t͡sarìːt͡sa/
cȃrstvo	/t͡sáːrstʋɔ/
cẹ̑h	/t͡séːx/
cekȋn	/t͡sɛkíːn/
cẹ̑ł	/t͡séːʋ/
celína	/t͡sɛlìːna/
celọ̑	/t͡sɛlóː/
celóta	/t͡sɛlɔ̀ːta/
cẹ́na	/t͡sèːna/
cenzȗra	/t͡sɛnzúːra/
cérij	/t͡sɛ̀ːrij/
cẹ́rkəv	/t͡sèːrkəʋ/
césar	/t͡sɛ̀ːsar/
cesaríca	/t͡sɛsarìːt͡sa/
cesȃrstvo	/t͡sɛsáːrstʋɔ/
cẹ́sta	/t͡sèːsta/
cẹ̑v	/t͡séːʋ/
cẹ́zij	/t͡sèːzij/
cigāra	/t͡siɡàːra/
cigarẹ̑ta	/t͡siɡaréːta/
-cija	/-t͡sija/
ciklọ̑n	/t͡siklóːn/
cȋlj	/t͡síːl/
cīmet	/t͡sìːmɛt/
Cípər	/t͡sìːpər/
klobučár	/klɔbut͡ʃàːr/
rẹ̑d	/réːt/
do	/dÉ”/
vratȉč	/ʋratít͡ʃ/
otáva	/ɔtàːʋa/
slȁb	/sláp/
zgréšiti	/zɡrɛ̀ːʃiti/
vółga	/ʋɔ̀ːʋɡa/
čẹ́maž	/t͡ʃèːmaʃ/
se	/sɛ/
odrešeník	/ɔdrɛʃɛnìːk/
gáms	/ɡàːms/
lẹ́šnik	/lèːʃnik/
vọ̑jvodina	/ʋóːjʋɔdina/
mīrna Bọ̑sna	/mìːrna bóːsna/
dóbro jútro	/dɔ̀ːbrɔ jùːtrɔ/
diják	/dijàːk/
podgána	/pɔdɡàːna/
medeníca	/mɛdɛnìːt͡sa/
kẹ́lih	/kèːlix/
cọ̑na	/t͡sóːna/
cúla	/t͡sùːla/
cvȅk	/t͡sʋɛ́k/
cvə̀sti	/t͡sʋə̀sti/
cvẹ̑tən	/t͡sʋéːtən/
cvíliti	/t͡sʋìːliti/
cvȓčək	/t͡sʋə́rt͡ʃək/
cvrẹ́ti	/t͡sʋrèːti/
č	/t͡ʃ/
Čȃd	/t͡ʃáːt/
čȃj	/t͡ʃáːj/
čákati	/t͡ʃàːkati/
čȃo	/t͡ʃáːɔ/
čȃplja	/t͡ʃáːplja/
čarȏvnica	/t͡ʃarɔ́ːʋnit͡sa/
čarȏvnik	/t͡ʃarɔ́ːʋnik/
čȁs	/t͡ʃás/
čȃsnik	/t͡ʃáːsnik/
časopȋs	/t͡ʃasɔpíːs/
čȃst	/t͡ʃáːst/
částna besẹ̑da	/t͡ʃàːstna bɛséːda/
čáša	/t͡ʃàːʃa/
če	/t͡ʃɛ/
čebẹ̑la	/t͡ʃɛbéːla/
čebúla	/t͡ʃɛbùːla/
Čefúr	/t͡ʃɛfùːr/
Čẹ̑h	/t͡ʃéːx/
Čẹ̑hinja	/t͡ʃéːxinja/
čẹ̑k	/t͡ʃéːk/
čélo	/t͡ʃɛ̀ːlɔ/
čẹ́maž	/t͡ʃèːmaʃ/
čeprȁv	/t͡ʃɛpráʋ/
česmína	/t͡ʃɛsmìːna/
Čẹ̑ška	/t͡ʃéːʃka/
Čẹ̑ška Repúblika	/t͡ʃéːʃka rɛpùːblika/
čẹ̑ški	/t͡ʃéːʃki/
Čẹ̑škoslovȃška	/t͡ʃéːʃkɔslɔʋáːʃka/
čẹ̑šplja	/t͡ʃéːʃplja/
četrtȋnka	/t͡ʃɛtərtíːnka/
čẹ̑vljekljȗn	/t͡ʃéːʋljɛkljúːn/
-či	/-t͡ʃi/
Čífut	/t͡ʃìːfut/
čȋgar	/t͡ʃíːɡar/
čigáv	/t͡ʃiɡàːʋ/
Čȋle	/t͡ʃíːlɛ/
čȋpka	/t͡ʃíːpka/
čȋst	/t͡ʃíːst/
čístiti	/t͡ʃìːstiti/
čistóta	/t͡ʃistɔ̀ːta/
čītati	/t͡ʃìːtati/
čivȃva	/t͡ʃiʋáːʋa/
člȃn	/t͡ʃláːn/
člȃnək	/t͡ʃláːnək/
čokolȃda	/t͡ʃɔkɔláːda/
čȏłn	/t͡ʃɔ́ːʋn/
čọ̑pič	/t͡ʃóːpit͡ʃ/
čŕka	/t͡ʃə̀rka/
črkováti	/t͡ʃərkɔʋàːti/
čŕn	/t͡ʃə̀rn/
Čŕna góra	/t͡ʃə̀rna ɡɔ̀ːra/
čŕna lȗknja	/t͡ʃə̀rna lúːknja/
črnílo	/t͡ʃərnìːlɔ/
črnogọ̑rski	/t͡ʃərnɔɡóːrski/
čȓv	/t͡ʃə́rʋ/
čȗstvən	/t͡ʃúːstʋən/
čȗstvo	/t͡ʃúːstʋɔ/
čȗt	/t͡ʃúːt/
čúti	/t͡ʃùːti/
čutīti	/t͡ʃutìːti/
dȁ	/dá/
dajȃləc	/dajáːlət͡s/
dáleč	/dàːlɛt͡ʃ/
dálija	/dàːlija/
dȁlj	/dál/
dȃljšati	/dáːlʃati/
dȃljši	/dáːlʃi/
dáma	/dàːma/
Damȃsk	/damáːsk/
dȃmjak	/dáːmjak/
dȃn	/dáːn/
dȃndánəs	/dáːndàːnəs/
Dȃnəc	/dáːnət͡s/
dánəs	/dàːnəs/
Dȃnka	/dáːnka/
Dȃnska	/dáːnska/
dȃnski	/dáːnski/
dȃnsko	/dáːnskɔ/
dȃnščina	/dáːnʃt͡ʃina/
dȃr	/dáːr/
darílo	/darìːlɔ/
darováti	/darɔʋàːti/
dátəlj	/dàːtəl/
dáti	/dàːti/
dȃtiv	/dáːtiʋ/
dātum	/dàːtum/
débeł	/dɛ̀ːbɛʋ/
debelȇjši	/dɛbɛlɛ́ːjʃi/
debẹ́lo črevọ̑	/dɛbèːlɔ t͡ʃrɛʋóː/
decémbər	/dɛt͡sɛ̀ːmbər/
dẹ̑d	/déːt/
dedováti	/dɛdɔʋàːti/
dejȃnje	/dɛjáːnjɛ/
dejáti	/dɛjàːti/
dejāvnejši	/dɛjàːʋnɛjʃi/
deklȅ	/dɛklɛ́/
dẹ́lati	/dèːlati/
dẹ́lavəc	/dèːlaʋət͡s/
delfȋn	/dɛlfíːn/
dẹ́lo	/dèːlɔ/
denár	/dɛnàːr/
denȃrnica	/dɛnáːrnit͡sa/
dendrokronologíja	/dɛndrɔkrɔnɔlɔɡìːja/
desẹ̑t	/dɛséːt/
desetlẹ̑tje	/dɛsɛtléːtjɛ/
desẹ̑tnica	/dɛséːtnit͡sa/
dẹ́təl	/dèːtəl/
dẹ́ti	/dèːti/
dẹ̑va	/déːʋa/
deverbatȋvən	/dɛʋɛrbatíːʋən/
devẹ̑t	/dɛʋéːt/
devẹ̑tdeset	/dɛʋéːddɛsɛt/
devẹ̑tnajst	/dɛʋéːtnajst/
devíca	/dɛʋìːt͡sa/
də̏ž	/də́ʃ/
dežéla	/dɛʒɛ̀ːla/
dəževáti	/dəʒɛʋàːti/
dəžník	/dəʒnìːk/
dijamānt	/dijamàːnt/
diamȃntən	/diamáːntən/
díhati	/dìːxati/
dihūr	/dixùːr/
diják	/dijàːk/
dȉm	/dím/
dīmlje	/dìːmljɛ/
dȋmnik	/díːmnik/
dinozávər	/dinɔzàːʋər/
dirigȅnt	/diriɡɛ́nt/
dȋrka	/díːrka/
diskriminácija	/diskriminàːt͡sija/
disprọ́zij	/dispròːzij/
díti	/dìːti/
divizȋja	/diʋizíːja/
dívja mȃčka	/dìːʋja máːt͡ʃka/
dívji petélin	/dìːʋji pɛtɛ̀ːlin/
dláka	/dlàːka/
dlȃn	/dláːn/
dlẹ́to	/dlèːtɔ/
dnẹ̑vnik	/dnéːʋnik/
do	/dÉ”/
do-	/dɔ-/
dọ̑b	/dóːp/
dóba	/dɔ̀ːba/
dóbro	/dɔ̀ːbrɔ/
dóbro jútro	/dɔ̀ːbrɔ jùːtrɔ/
dobrodóšəł	/dɔbrɔdɔ̀ːʃəʋ/
klobučár	/klɔbut͡ʃàːr/
rẹ̑d	/réːt/
do	/dÉ”/
vratȉč	/ʋratít͡ʃ/
otáva	/ɔtàːʋa/
slȁb	/sláp/
zgréšiti	/zɡrɛ̀ːʃiti/
vółga	/ʋɔ̀ːʋɡa/
čẹ́maž	/t͡ʃèːmaʃ/
se	/sɛ/
odrešeník	/ɔdrɛʃɛnìːk/
gáms	/ɡàːms/
lẹ́šnik	/lèːʃnik/
vọ̑jvodina	/ʋóːjʋɔdina/
mīrna Bọ̑sna	/mìːrna bóːsna/
dóbro jútro	/dɔ̀ːbrɔ jùːtrɔ/
diják	/dijàːk/
podgána	/pɔdɡàːna/
medeníca	/mɛdɛnìːt͡sa/
kẹ́lih	/kèːlix/
dogājati	/dɔɡàːjati/
dogọ̑dək	/dɔɡóːdək/
dogọ̑dkovno obzọ̑rje	/dɔɡóːtkɔʋnɔ ɔbzóːrjɛ/
dogȏvor	/dɔɡɔ́ːʋɔr/
dojénčək	/dɔjɛ̀ːnt͡ʃək/
dojílja	/dɔjìːlja/
doklȅr	/dɔklɛ́r/
dól	/dɔ̀ːl/
dȏlg	/dɔ́ːʋk/
dołgočásən	/dɔʋɡɔt͡ʃàːsən/
dolgočásnejši	/dɔlɡɔt͡ʃàːsnɛjʃi/
dołgovalȏvən	/dɔʋɡɔʋalɔ́ːʋən/
dolína	/dɔlìːna/
dọ̑m	/dóːm/
domȃ	/dɔmáː/
domišljȋja	/dɔmiʃljíːja/
domōv	/dɔmɔ̀ːʋ/
domovína	/dɔmɔʋìːna/
Dọ̑nava	/dóːnaʋa/
dopȏłdan	/dɔpɔ́ːʋdan/
dotaknīti	/dɔtaknìːti/
dovoljénje	/dɔʋɔljɛ̀ːnjɛ/
drȃg	/dráːk/
dragūlj	/draɡùːl/
drȃžji	/dráːʒji/
drȅn	/drɛ́n/
dȓka	/də́rka/
dȓkajo	/də́rkajɔ/
dȓkajte	/də́rkajtɛ/
dȓkam	/də́rkam/
dȓkamo	/də́rkamɔ/
dȓkanje	/də́rkanjɛ/
dȓkata	/də́rkata/
dȓkati	/də́rkati/
dȓkava	/də́rkaʋa/
dróbən	/drɔ̀ːbən/
drobíž	/drɔbìːʃ/
drobnják	/drɔbnjàːk/
drọ̑g	/dróːk/
dromedár	/drɔmɛdàːr/
drọ̑mlja	/dróːmlja/
drọ̑zd	/dróːst/
drọ̑zg	/dróːsk/
drsẹ́ti	/dərsèːti/
drȗg	/drúːk/
drūgi	/drùːɡi/
drugótən	/druɡɔ̀ːtən/
drȗžba	/drúːʒba/
družína	/druʒìːna/
dŕva	/də̀rʋa/
držȃva	/dərʒáːʋa/
dūcat	/dùːt͡sat/
dȗda	/dúːda/
dūde	/dùːdɛ/
dȗh	/dúːx/
Dúnaj	/dùːnaj/
dúša	/dùːʃa/
dušȋk	/duʃíːk/
dvȃ	/dʋáː/
dvȃ pára	/dʋáː pàːra/
dvȃjset	/dʋáːjsɛt/
dvanȃjst	/dʋanáːjst/
dvẹ̑	/dʋéː/
dvígniti	/dʋìːɡniti/
dvọ̄jčək	/dʋòːjt͡ʃək/
dvojína	/dʋɔjìːna/
dvọ̑jka	/dʋóːjka/
dvọ̑m	/dʋóːm/
dvọ̄miti	/dʋòːmiti/
dvọ̑pȋčje	/dʋóːpíːt͡ʃjɛ/
dvọ̑vȋdski	/dʋóːʋíːtski/
džámija	/d͡ʒàːmija/
džẹ̑z	/d͡ʒéːs/
džihȃd	/d͡ʒixáːt/
džȗngla	/d͡ʒúːnɡla/
édən	/ɛ̀ːdən/
Egȇjsko mọ̑rje	/ɛɡɛ́ːjskɔ móːrjɛ/
ejakulácija	/ɛjakulàːt͡sija/
ekonomȋja	/ɛkɔnɔmíːja/
ekonomȋst	/ɛkɔnɔmíːst/
ẹ̑kosistẹ̑m	/éːkɔsistéːm/
ẹ̑ksodus	/éːksɔdus/
elẹ̑ktrični tọ̑k	/ɛléːktrit͡ʃni tóːk/
elẹ̑ktromagnẹ̑tna interákcija	/ɛléːktrɔmaɡnéːtna intɛràːkt͡sija/
elektrọ́n	/ɛlɛktròːn/
-ən	/-ən/
êna	/ɛ̀ːna/
enȃčba	/ɛnáːd͡ʒba/
ēnaindvȃjset	/ɛ̀ːnaindʋáːjsɛt/
enájst	/ɛnàːjst/
enóta	/ɛnɔ̀ːta/
entomologȋja	/ɛntɔmɔlɔɡíːja/
epicẹ̄ntər	/ɛpit͡sèːntər/
epistemologíja	/ɛpistɛmɔlɔɡìːja/
érbij	/ɛ̀ːrbij/
Ȇrik	/ɛ́ːrik/
Eritrȇja	/ɛritrɛ́ːja/
erogẹ̑na cọ̑na	/ɛrɔɡéːna t͡sóːna/
Eržẹ̑n	/ɛrʒéːn/
esȇj	/ɛsɛ́ːj/
Estọ̑nəc	/ɛstóːnət͡s/
Estọ́nija	/ɛstòːnija/
estọ̑nski	/ɛstóːnski/
estọ̑nščina	/ɛstóːnʃt͡ʃina/
-eváti	/-ɛʋàːti/
ẹ̑vo	/éːʋɔ/
Evrọ̑pa	/ɛʋróːpa/
evrọ́pij	/ɛʋròːpij/
fagọ̑t	/faɡóːt/
fakultẹ̑ta	/fakultéːta/
falzẹ̑t	/falzéːt/
fȁnt	/fánt/
fazȃn	/fazáːn/
fẹ̑bruar	/féːbruar/
Felicijȃn	/fɛlit͡sijáːn/
fẹ̑niks	/féːniks/
férmij	/fɛ̀ːrmij/
fíga	/fìːɡa/
filẹ̑	/filéː/
Filipȋni	/filipíːni/
filozọ̑f	/filɔzóːf/
fȋn	/fíːn/
Fȋnəc	/fíːnət͡s/
Fȋnka	/fíːnka/
Fȋnska	/fíːnska/
fȋnsko	/fíːnskɔ/
fȋnščina	/fíːnʃt͡ʃina/
fízika	/fìːzika/
fižȍł	/fiʒɔ́ʋ/
fọ̑sfor	/fóːsfɔr/
fotogrȃf	/fɔtɔɡráːf/
fotografȋja	/fɔtɔɡrafíːja/
Frȁnc	/fránt͡s/
fráncij	/fràːnt͡sij/
francọ̑sko	/frant͡sóːskɔ/
Francọ̑z	/frant͡sóːs/
Francọ̑zinja	/frant͡sóːzinja/
fukajọ̄č	/fukajòːt͡ʃ/
fȗkati	/fúːkati/
gadolínij	/ɡadɔlìːnij/
galẹ̑b	/ɡaléːp/
Galícija	/ɡalìːt͡sija/
gálij	/ɡàːlij/
gáms	/ɡàːms/
gáziti	/ɡàːziti/
generȃl	/ɡɛnɛráːl/
gẹ́nij	/ɡèːnij/
genocȋd	/ɡɛnɔt͡síːt/
geodezȋja	/ɡɛɔdɛzíːja/
klobučár	/klɔbut͡ʃàːr/
rẹ̑d	/réːt/
do	/dÉ”/
vratȉč	/ʋratít͡ʃ/
otáva	/ɔtàːʋa/
slȁb	/sláp/
zgréšiti	/zɡrɛ̀ːʃiti/
vółga	/ʋɔ̀ːʋɡa/
čẹ́maž	/t͡ʃèːmaʃ/
se	/sɛ/
odrešeník	/ɔdrɛʃɛnìːk/
gáms	/ɡàːms/
lẹ́šnik	/lèːʃnik/
vọ̑jvodina	/ʋóːjʋɔdina/
mīrna Bọ̑sna	/mìːrna bóːsna/
dóbro jútro	/dɔ̀ːbrɔ jùːtrɔ/
diják	/dijàːk/
podgána	/pɔdɡàːna/
medeníca	/mɛdɛnìːt͡sa/
kẹ́lih	/kèːlix/
geografȋja	/ɡɛɔɡrafíːja/
geologȋja	/ɡɛɔlɔɡíːja/
gẹ̑pard	/ɡéːpart/
germánij	/ɡɛrmàːnij/
géslo	/ɡɛ̀ːslɔ/
gíbanje	/ɡìːbanjɛ/
gimnázija	/ɡimnàːzija/
gladȋlka	/ɡladíːlka/
glágol	/ɡlàːɡɔl/
glagọ̑lica	/ɡlaɡóːlit͡sa/
glágolnik	/ɡlàːɡɔlnik/
glágolski	/ɡlàːɡɔlski/
glȃs	/ɡláːs/
glȃsba	/ɡláːzba/
glȃsben	/ɡláːzbɛn/
glȃsbeni inštrumȅnt	/ɡláːzbɛni inʃtrumɛ́nt/
glȃsbenik	/ɡláːzbɛnik/
glásən	/ɡlàːsən/
glasnȇjši	/ɡlasnɛ́ːjʃi/
gláva	/ɡlàːʋa/
glāvən	/ɡlàːʋən/
glavník	/ɡlaʋnìːk/
glȃvno mẹ́sto	/ɡláːʋnɔ mèːstɔ/
glẹ́dati	/ɡlèːdati/
glẹ́žənj	/ɡlèːʒən/
glọ̑blji	/ɡlóːblji/
globȍk	/ɡlɔbɔ́k/
glȗh	/ɡlúːx/
glȗšji	/ɡlúːʃji/
gnáti	/ɡnàːti/
gnȋł	/ɡníːʋ/
gníti	/ɡnìːti/
gnọ́stičən	/ɡnòːstit͡ʃən/
gọ́ba	/ɡòːba/
gọ̑d	/ɡóːt/
gȍł	/ɡɔ́ʋ/
golobíca	/ɡɔlɔbìːt͡sa/
golobrȃd	/ɡɔlɔbráːt/
gȏłt	/ɡɔ́ːʋt/
gonorȇja	/ɡɔnɔrɛ́ːja/
gór	/ɡɔ̀ːr/
góra	/ɡɔ̀ːra/
gorčíca	/ɡɔrt͡ʃìːt͡sa/
gorẹ́ti	/ɡɔrèːti/
goríca	/ɡɔrìːt͡sa/
Goríca	/ɡɔrìːt͡sa/
gorívo	/ɡɔrìːʋɔ/
gọ̑s	/ɡóːs/
gosẹ̑nica	/ɡɔséːnit͡sa/
gospá	/ɡɔspàː/
gospọ̑d	/ɡɔspóːt/
gospodár	/ɡɔspɔdàːr/
gospodȋčna	/ɡɔspɔdíːt͡ʃna/
gȍst	/ɡɔ́st/
gọ́sti	/ɡòːsti/
gostȋtelj	/ɡɔstíːtɛl/
govẹ̑dina	/ɡɔʋéːdina/
govẹ̑do	/ɡɔʋéːdɔ/
góvno	/ɡɔ̀ːʋnɔ/
gȏvor	/ɡɔ́ːʋɔr/
govọ̑rəc	/ɡɔʋóːrət͡s/
govorīti	/ɡɔʋɔrìːti/
gozdȃrstvo	/ɡɔzdáːrstʋɔ/
gráblje	/ɡràːbljɛ/
grȃd	/ɡráːt/
Grȃdəc	/ɡráːdət͡s/
grȁh	/ɡráx/
grȃnica	/ɡráːnit͡sa/
grápa	/ɡràːpa/
gravitácija	/ɡraʋitàːt͡sija/
gȓb	/ɡə́rp/
gȓd	/ɡə́rt/
grébsti	/ɡrɛ̀ːpsti/
Grẹ̑nlȃndija	/ɡréːnláːndija/
grípa	/ɡrìːpa/
gríva	/ɡrìːʋa/
Gȓk	/ɡə́rk/
gŕlo	/ɡə̀rlɔ/
gȓm	/ɡə́rm/
grȍb	/ɡrɔ́p/
grȍf	/ɡrɔ́f/
grofíca	/ɡrɔfìːt͡sa/
grozljív	/ɡrɔzljìːʋ/
grozljívejši	/ɡrɔzljìːʋɛjʃi/
gȓščina	/ɡə́rʃt͡ʃina/
gȓši	/ɡə́rʃi/
gȓški	/ɡə́rʃki/
gȓško	/ɡə́rʃkɔ/
Grȗzija	/ɡrúːzija/
grȗzijski	/ɡrúːzijski/
gruzȋnski	/ɡruzíːnski/
gúba	/ɡùːba/
gubīti	/ɡubìːti/
gȗmb	/ɡúːmp/
Gvajȃna	/ɡʋajáːna/
Gvinȇja	/ɡʋinɛ́ːja/
Haag	/xáːk/
Habakȗk	/xabakúːk/
hadrọ̑n	/xadróːn/
háfnij	/xàːfnij/
haȋtijski	/xaíːtijski/
halucinácija	/xalut͡sinàːt͡sija/
hȃrfa	/xáːrfa/
harmọ́nika	/xarmòːnika/
hasidȋzəm	/xasidíːzəm/
hȃšiš	/xáːʃiʃ/
hčȋ	/xt͡ʃíː/
heksagọ̑n	/xɛksaɡóːn/
hẹ̑kto-	/xéːktɔ/
hẹ̑ktolítər	/xéːktɔlìːtər/
hẹ́lij	/xèːlij/
hematologȋja	/xɛmatɔlɔɡíːja/
heráldika	/xɛràːldika/
hermelȋn	/xɛrmɛlíːn/
Herọ̑dot	/xɛróːdɔt/
Heziọ̑d	/xɛzijóːt/
híba	/xìːba/
hidrologȋja	/xidrɔlɔɡíːja/
hȋdžra	/xíːd͡ʒra/
hȋp	/xíːp/
híša	/xìːʃa/
hitréje	/xitrɛ̀ːjɛ/
hitréjše	/xitrɛ̀ːjʃɛ/
hítro	/xìːtrɔ/
hitrọ̑st	/xitróːst/
hláče	/xlàːt͡ʃɛ/
hládna vójna	/xlàːdna ʋɔ̀ːjna/
	
hobọ̑tnica	/xɔbóːtnit͡sa/
hodīti	/xɔdìːti/
holȃndski	/xɔláːntski/
họ̄lm	/xòːlm/
họ́lmij	/xòːlmij/
homoseksuȃlən	/xɔmɔsɛksuáːlən/
homoseksuȃlnost	/xɔmɔsɛksuáːlnɔst/
horizọ̑nt dogọ̑dkov	/xɔrizóːnt dɔɡóːtkɔʋ/
Họ̑stnik	/xóːstnik/
hrást	/xràːst/
hŕbət	/xə̀rbət/
hríb	/xrìːp/
hrípav	/xrìːpaʋ/
hrópsti	/xrɔ̀ːpsti/
hrȍšč	/xrɔ́ʃt͡ʃ/
hrȗp	/xrúːp/
hrvȃščina	/xərʋáːʃt͡ʃina/
klobučár	/klɔbut͡ʃàːr/
rẹ̑d	/réːt/
do	/dÉ”/
vratȉč	/ʋratít͡ʃ/
otáva	/ɔtàːʋa/
slȁb	/sláp/
zgréšiti	/zɡrɛ̀ːʃiti/
vółga	/ʋɔ̀ːʋɡa/
čẹ́maž	/t͡ʃèːmaʃ/
se	/sɛ/
odrešeník	/ɔdrɛʃɛnìːk/
gáms	/ɡàːms/
lẹ́šnik	/lèːʃnik/
vọ̑jvodina	/ʋóːjʋɔdina/
mīrna Bọ̑sna	/mìːrna bóːsna/
dóbro jútro	/dɔ̀ːbrɔ jùːtrɔ/
diják	/dijàːk/
podgána	/pɔdɡàːna/
medeníca	/mɛdɛnìːt͡sa/
kẹ́lih	/kèːlix/
Hrvȃška	/xərʋáːʃka/
hȗd	/xúːt/
hȗjši	/xúːjʃi/
húrija	/xùːrija/
hurȋska	/xuríːska/
husȋt	/xusíːt/
hvála	/xʋàːla/
hvalīti	/xʋalìːti/
igọ̑	/iɡóː/
ȋgra	/íːɡra/
igráča	/iɡràːt͡ʃa/
igrȃləc	/iɡráːlət͡s/
-ija	/-ija/
imȃm vprašȃnje	/imáːm ʋpraʃáːnjɛ/
imẹ̑	/iméː/
imenovȃlnik	/imɛnɔʋáːlnik/
imenováti	/imɛnɔʋàːti/
imẹ́ti	/imèːti/
in	/in/
-ina	/-ina/
índij	/ìːndij/
Índija	/ìːndija/
Índijəc	/íːndijət͡s/
Índijka	/ìːndijka/
índijski	/ìːndijski/
Indonẹ́zija	/indɔnèːzija/
informátik	/infɔrmàːtik/
īngver	/ìːnɡʋɛr/
insẹ̑kt	/inséːkt/
ȋnstrumental	/íːnstrumɛntal/
instrumentȃlən	/instrumɛntáːlən/
inštitȗt	/inʃtitúːt/
Irȃk	/iráːk/
Ȋrəc	/íːrət͡s/
irídij	/irìːdij/
Ȋrka	/íːrka/
Ȋrska	/íːrska/
ȋrski	/íːrski/
iskáti	/iskàːti/
ȋslam	/íːslam/
Islándija	/islàːndija/
islȃndski	/isláːntski/
Ȋstanbul	/íːstanbul/
ȋsti	/íːsti/
Ȋstra	/íːstra/
Itálija	/itàːlija/
Italijȃnka	/italijáːnka/
italijȃnski	/italijáːnski/
italijȃnščina	/italijáːnʃt͡ʃina/
īti	/ìːti/
ítrij	/ìːtrij/
Ȋvan	/íːʋan/
iz-	/iz-/
izdajȃləc	/izdajáːlət͡s/
izdáti	/izdàːti/
izgovorīti	/izɡɔʋɔrìːti/
izgovorjȃva	/izɡɔʋɔrjáːʋa/
izgubīti	/izɡubìːti/
izkljúčiti	/iskljùːt͡ʃiti/
izklopīti	/isklɔpìːti/
ȋzkrcánje	/íːskərt͡sàːnjɛ/
izlọ̑žba	/izlóːʒba/
izmółsti	/izmɔ̀ːʋsti/
izpeljáti	/ispɛljàːti/
izposodīti	/ispɔsɔdìːti/
Ȋzrael	/íːzraɛl/
izúti	/izùːti/
izvijáč	/izʋijàːt͡ʃ/
jā	/jàː/
jábołko	/jàːbɔʋkɔ/
jādro	/jàːdrɔ/
jágnje	/jàːɡnjɛ/
jāgnjec	/jàːɡnjɛt͡s/
jágoda	/jàːɡɔda/
jāhati	/jàːxati/
jájce	/jàːjt͡sɛ/
jȃjčnik	/jáːjt͡ʃnik/
Jȃkac	/jáːkat͡s/
jáma	/jàːma/
Jamȃjka	/jamáːjka/
Jánez	/jàːnɛs/
Jánez Krstník	/jàːnɛz kərstnìːk/
	
jȃnuar	/jáːnuar/
Japọ̑nska	/japóːnska/
jārək	/jàːrək/
járəm	/jàːrəm/
jásən	/jàːsən/
jásnejši	/jàːsnɛjʃi/
jasnīti	/jasnìːti/
jȃspis	/jáːspis/
jȃspisən	/jáːspisən/
jȃstreb	/jáːstrɛp/
jáviti	/jàːʋiti/
jávor	/jàːʋɔr/
jȁz	/jás/
jȁz ne razȗmem	/jáz nɛ razúːmɛm/
jȃzbəc	/jáːzbət͡s/
jȅ	/jɛ́/
jẹ̑bati	/jéːbati/
jéčmen	/jɛ̀ːt͡ʃmɛn/
jéklo	/jɛ̀ːklɔ/
jélen	/jɛ̀ːlɛn/
jemáti	/jɛmàːti/
jerebíca	/jɛrɛbìːt͡sa/
jesẹ̑n	/jɛséːn/
jẹ́tika	/jèːtika/
jẹ́tra	/jèːtra/
jẹ́za	/jèːza/
jẹ̑zero	/jéːzɛrɔ/
jezikoslȏvəc	/jɛzikɔslɔ́ːʋət͡s/
jezikoslȏvje	/jɛzikɔslɔ́ːʋjɛ/
jẹ́znejši	/jèːznɛjʃi/
Jẹ̑zus Krȋstus	/jéːzus kríːstus/
jẹ̄ž	/jèːʃ/
Jẹ̄ž	/jèːʃ/
jọ̑d	/jóːt/
jọ̑gurt	/jóːɡurt/
jordȃnski	/jɔrdáːnski/
Jọ̑že	/jóːʒɛ/
júdovstvo	/jùːdɔʋstʋɔ/
jȗg	/júːk/
júha	/jùːxa/
júlij	/jùːlij/
júnij	/jùːnij/
Jȗpitər	/júːpitər/
júr	/jùːr/
jútro	/jùːtrɔ/
Jȗvan	/júːʋan/
júžina	/jùːʒina/
káča	/kàːt͡ʃa/
kȃčji pastír	/káːt͡ʃji pastìːr/
kȁd	/kát/
kȁdar	/kádar/
kadīti	/kadìːti/
kádmij	/kàːdmij/
kȃjak	/káːjak/
kakọ̄	/kakòː/
kakọ̄ sȉ?	/kakòː sí/
kȁkor	/kákɔr/
kȁkor si bọ̑š postlȁł, takọ̑ bọ̑š spȃł	/kákɔr si bóːʃ pɔstláʋ, takóː bóːʃ spáːʋ/
kakóvost	/kakɔ̀ːʋɔst/
klobučár	/klɔbut͡ʃàːr/
rẹ̑d	/réːt/
do	/dÉ”/
vratȉč	/ʋratít͡ʃ/
otáva	/ɔtàːʋa/
slȁb	/sláp/
zgréšiti	/zɡrɛ̀ːʃiti/
vółga	/ʋɔ̀ːʋɡa/
čẹ́maž	/t͡ʃèːmaʃ/
se	/sɛ/
odrešeník	/ɔdrɛʃɛnìːk/
gáms	/ɡàːms/
lẹ́šnik	/lèːʃnik/
vọ̑jvodina	/ʋóːjʋɔdina/
mīrna Bọ̑sna	/mìːrna bóːsna/
dóbro jútro	/dɔ̀ːbrɔ jùːtrɔ/
diják	/dijàːk/
podgána	/pɔdɡàːna/
medeníca	/mɛdɛnìːt͡sa/
kẹ́lih	/kèːlix/
kākšən	/kàːkʃən/
kálcij	/kàːlt͡sij/
kálcijev karbonȃt	/kàːlt͡sijɛʋ karbɔnáːt/
kalifọ́rnij	/kalifòːrnij/
Kalifọ́rnija	/kalifòːrnija/
kálij	/kàːlij/
kamẹ̑la	/kaméːla/
kámən	/kàːmən/
Kȃmerun	/káːmɛrun/
kamȋn	/kamíːn/
kamiọ̑n	/kamijóːn/
Kȃnada	/káːnada/
kȃnjon	/káːnjɔn/
kápati	/kàːpati/
kapẹ̑tan	/kapéːtan/
kapẹ̑tanka	/kapéːtanka/
kapitalȋst	/kapitalíːst/
kapitalízəm	/kapitalìːzəm/
káplja	/kàːplja/
karamẹ̑la	/karaméːla/
kȃrta	/káːrta/
kášəlj	/kàːʃəl/
Katalọ́nija	/katalòːnija/
katalọ̑nščina	/katalóːnʃt͡ʃina/
katedrȃla	/katɛdráːla/
kategoriȃlən	/katɛɡɔrijáːlən/
kategorȋja	/katɛɡɔríːja/
káva	/kàːʋa/
kȃvsati	/káːʋsati/
Kȃzahstan	/káːzaxstan/
kázati	/kàːzati/
kaznováti	/kaznɔʋàːti/
kdāj	/ɡdàːj/
kdọ̄	/ɡdòː/
kẹ́lih	/kèːlix/
Kẹ̑lt	/kéːlt/
kemȋja	/kɛmíːja/
kẹ̑nta	/kéːnta/
ker	/kɛr/
Kȇrn	/kɛ́ːrn/
Kersník	/kɛrsnìːk/
ki	/ki/
kikirikȋ	/kikirikíː/
kȋlo-	/kíːlɔ/
kilomẹ́ter	/kilɔmèːtər/
kinȋn	/kiníːn/
kȋno	/kíːnɔ/
kȋp	/kíːp/
kiríj	/kirìːj/
kȋs	/kíːs/
kísəł	/kìːsəʋ/
kisȋk	/kisíːk/
kislína	/kislìːna/
kȋt	/kíːt/
kíta	/kìːta/
Kitȃjəc	/kitáːjət͡s/
Kitȃjka	/kitáːjka/
Kitȃjska	/kitáːjska/
kitȃjski	/kitáːjski/
kitȃjščina	/kitáːjʃt͡ʃina/
kitȃra	/kitáːra/
kjẹ̄	/kjèː/
kjẹ̑r	/kjéːr/
kládivce	/klàːdiʋt͡sɛ/
kládivo	/klàːdiʋɔ/
klȃs	/kláːs/
klásičən	/klàːsit͡ʃən/
kláti	/klàːti/
klèn	/klɛ̀n/
klepáti	/klɛpàːti/
Klépəc	/klɛ̀ːpət͡s/
klẹ́šče	/klèːʃt͡ʃɛ/
klȋc	/klíːt͡s/
klicȃj	/klit͡sáːj/
klícati	/klìːt͡sati/
klīma	/klìːma/
kljúč	/kljùːt͡ʃ/
ključȃvnica	/kljut͡ʃáːʋnit͡sa/
kljúkica	/kljùːkit͡sa/
kljȗn	/kljúːn/
kljunáš	/kljunàːʃ/
klobása	/klɔbàːsa/
klobučár	/klɔbut͡ʃàːr/
klobúk	/klɔbùːk/
klofúta	/klɔfùːta/
klọ̑kan	/klóːkan/
klọ̑p	/klóːp/
klopotáča	/klɔpɔtàːt͡ʃa/
klọ̑r	/klóːr/
klorofȋl	/klɔrɔfíːl/
klošár	/klɔʃàːr/
klȍšč	/klɔ́ʃt͡ʃ/
klóvn	/klɔ̀ːʋn/
kmȃlu	/kmáːlu/
kmȅt	/kmɛ́t/
Kmȅt	/kmɛ́t/
kmetȋja	/kmɛtíːja/
knẹ̑z	/knéːs/
knjíga	/knjìːɡa/
knjižẹ̑vnost	/knjiʒéːʋnɔst/
knjȋžna políca	/knjíːʒna pɔlìːt͡sa/
ko	/kÉ”/
kobíla	/kɔbìːla/
kobílica	/kɔbìːlit͡sa/
kọ̑cka	/kóːt͡ska/
kọ̑ckati	/kóːt͡skati/
kočȋja	/kɔt͡ʃíːja/
kọ́dər	/kòːdər/
Kọ́kalj	/kòːkal/
kọ́kalj	/kòːkal/
kokọ̑š	/kɔkóːʃ/
kóla	/kɔ̀ːla/
koledár	/kɔlɛdàːr/
kọ̑ledž	/kóːlɛtʃ/
kolẹ́no	/kɔlèːnɔ/
količína	/kɔlit͡ʃìːna/
kọ̑lidž	/kóːlitʃ/
kọ̄liko	/kòːlikɔ/
kolọ̑	/kɔlóː/
kọ̑maj	/kóːmaj/
komár	/kɔmàːr/
komārčək	/kɔmàːrt͡ʃək/
komẹ̑t	/kɔméːt/
komọ̑ləc	/kɔmóːlət͡s/
kọ̑mpas	/kóːmpas/
komunízəm	/kɔmunìːzəm/
kondọ̑m	/kɔndóːm/
kónəc	/kɔ̀ːnət͡s/
kȍnj	/kɔ́n/
konkrẹ̑tən	/kɔnkréːtən/
konkrẹ̑tno	/kɔnkréːtnɔ/
kontinȅnt	/kɔntinɛ́nt/
kọ̑ntrabȃs	/kóːntrabáːs/
kọ̑p	/kóːp/
kopȃlnica	/kɔpáːlnit͡sa/
kọ́pati	/kòːpati/
kopẹ̑l	/kɔpéːl/
kọ́pər	/kòːpər/
kopíto	/kɔpìːtɔ/
kọ́pje	/kòːpjɛ/
kōpno	/kɔ̀ːpnɔ/
Korȇja	/kɔrɛ́ːja/
korenína	/kɔrɛnìːna/
Korọ̑šəc	/kɔróːʃət͡s/
Korọ̑ška	/kɔróːʃka/
korúza	/kɔrùːza/
kọ̑s	/kóːs/
kosílo	/kɔsìːlɔ/
kȍsȋnus	/kɔ́síːnus/
kosítər	/kɔsìːtər/
kọ́siti	/kòːsiti/
kọ̑st	/kóːst/
kóstanj	/kɔ̀ːstan/
kȍš	/kɔ́ʃ/
košȃra	/kɔʃáːra/
košȃrka	/kɔʃáːrka/
kot	/kɔt/
klobučár	/klɔbut͡ʃàːr/
rẹ̑d	/réːt/
do	/dÉ”/
vratȉč	/ʋratít͡ʃ/
otáva	/ɔtàːʋa/
slȁb	/sláp/
zgréšiti	/zɡrɛ̀ːʃiti/
vółga	/ʋɔ̀ːʋɡa/
čẹ́maž	/t͡ʃèːmaʃ/
se	/sɛ/
odrešeník	/ɔdrɛʃɛnìːk/
gáms	/ɡàːms/
lẹ́šnik	/lèːʃnik/
vọ̑jvodina	/ʋóːjʋɔdina/
mīrna Bọ̑sna	/mìːrna bóːsna/
dóbro jútro	/dɔ̀ːbrɔ jùːtrɔ/
diják	/dijàːk/
podgána	/pɔdɡàːna/
medeníca	/mɛdɛnìːt͡sa/
kẹ́lih	/kèːlix/
kováč	/kɔʋàːt͡ʃ/
Kováč	/kɔʋàːt͡ʃ/
kovánəc	/kɔʋàːnət͡s/
kováti	/kɔʋàːti/
kȏvnica	/kɔ́ːʋnit͡sa/
kóza	/kɔ̀ːza/
kozȃrəc	/kɔzáːrət͡s/
kozmologȋja	/kɔzmɔlɔɡíːja/
krȁj	/kráj/
krājina	/kràːjina/
krajšȃva	/krajʃáːʋa/
králj	/kràːl/
králjeva lẹ́stvica	/kràːljɛʋa lèːstʋit͡sa/
kraljevína	/kraljɛʋìːna/
krȁp	/kráp/
krȃs	/kráːs/
krásti	/kràːsti/
kráter	/kràːtɛr/
kratíca	/kratìːt͡sa/
kráva	/kràːʋa/
krẹ̑da	/kréːda/
krẹ́mpəlj	/krèːmpəl/
krenīti	/krɛnìːti/
krȋ	/kríː/
krȋk	/kríːk/
krílo	/krìːlɔ/
kristalizácija	/kristalizàːt͡sija/
Krȋstus	/kríːstus/
kríti	/krìːti/
krȋvda	/kríːʋda/
krivovẹ̑rəc	/kriʋɔʋéːrət͡s/
kríž	/krìːʃ/
krīžanje	/krìːʒanjɛ/
krȋžanka	/kríːʒanka/
kŕma	/kə̀rma/
krog	/krɔk/
krọ̑gla	/króːɡla/
krojáč	/krɔjàːt͡ʃ/
krọ̑kar	/króːkar/
krọ̑m	/króːm/
krompīr	/krɔmpìːr/
krọ̑na	/króːna/
krọ̑nati	/króːnati/
kȓst	/kə́rst/
kŕsta	/kə̀rsta/
krščȃnstvo	/kərʃt͡ʃáːnstʋɔ/
kȓt	/kə́rt/
krȕh	/krúx/
krúha ne naredí mọ́ka ȁmpak róka	/krùːxa nɛ narɛdìː mòːka ámpak rɔ̀ːka/
krvavẹ́ti	/kərʋaʋèːti/
ksenofobȋja	/ksɛnɔfɔbíːja/
ksẹ̑non	/kséːnɔn/
ksilofọ̑n	/ksilɔfóːn/
Kȗba	/kúːba/
kúga	/kùːɡa/
kúhati	/kùːxati/
kúkavica	/kùːkaʋit͡sa/
kúna	/kùːna/
kūnəc	/kùːnət͡s/
kȕp	/kúp/
kupīti	/kupìːti/
kupováti	/kupɔʋàːti/
kúra	/kùːra/
kȗrba	/kúːrba/
kȗrdščina	/kúːrtʃt͡ʃina/
kȗrəc	/kúːrət͡s/
kȗrva	/kúːrʋa/
kūščar	/kùːʃt͡ʃar/
kvadrȃt	/kʋadráːt/
kvȃr	/kʋáːr/
kvȃrk	/kʋáːrk/
kvartẹ̑t	/kʋartéːt/
kvȃs	/kʋáːs/
labọ̑d	/labóːt/
ládja	/làːdja/
lagáti	/laɡàːti/
láhək	/làːxək/
lahkọ̑	/laxkóː/
lahkọ̑ nọ̑č	/laxkóː nóːt͡ʃ/
lȃjati	/láːjati/
láma	/làːma/
láni	/làːni/
lantȃn	/lantáːn/
lȃs	/láːs/
lȃst	/láːst/
lástən	/làːstən/
lastnína	/lastnìːna/
lástovica	/làːstɔʋit͡sa/
lástovka	/làːstɔʋka/
latȋnica	/latíːnit͡sa/
latȋnski	/latíːnski/
latȋnščina	/latíːnʃt͡ʃina/
Látvija	/làːtʋija/
Látvijəc	/làːtʋijət͡s/
látvijsko	/làːtʋijskɔ/
lȃž	/láːʃ/
lȃžji	/láːʒji/
lažnȋvəc	/laʒníːʋət͡s/
lȅ	/lɛ́/
lẹ́či	/lèːt͡ʃi/
lẹ̑d	/léːt/
ledẹ̑na dóba	/lɛdéːna dɔ̀ːba/
ledeník	/lɛdɛnìːk/
lẹ́ha	/lèːxa/
lenȋvəc	/lɛníːʋət͡s/
Lẹ̑on	/léːɔn/
lẹ̑p	/léːp/
lẹ̑p pozdrȁv	/léːp pɔzdráʋ/
lepóta	/lɛpɔ̀ːta/
lẹ̑pši	/léːpʃi/
lẹ̑s	/léːs/
lẹ́ska	/lèːska/
lesketáti	/lɛskɛtàːti/
lẹ́stvica	/lèːstʋit͡sa/
lẹ́šnik	/lèːʃnik/
lȅt	/lɛ́t/
letalíšče	/lɛtalìːʃt͡ʃɛ/
letálo	/lɛtàːlɔ/
lẹ̑tən	/léːtən/
letẹ́ti	/lɛtèːti/
lẹ́to	/lèːtɔ/
lȅv	/lɛ́ʋ/
ležȃj	/lɛʒáːj/
ležáti	/lɛʒàːti/
Libérija	/libɛ̀ːrija/
libidinọ̑zən	/libidinóːzən/
lȋbido	/líːbidɔ/
Líbija	/lìːbija/
līce	/lìːt͡sɛ/
ličȋnka	/lit͡ʃíːnka/
lȋčnica	/líːt͡ʃnit͡sa/
líga	/lìːɡa/
liják	/lijàːk/
likȃlnik	/likáːlnik/
lȋkati	/líːkati/
limọ̑na	/limóːna/
limonȃda	/limɔnáːda/
lípa	/lìːpa/
Lípovəc	/lìːpɔʋət͡s/
lȋra	/líːra/
lȋst	/líːst/
lišȃj	/liʃáːj/
lítər	/lìːtər/
literatȗra	/litɛratúːra/
líti	/lìːti/
lítij	/lìːtij/
Lítovəc	/lìːtɔʋət͡s/
Lítovka	/lìːtɔʋka/
lȋtovski	/líːtɔʋski/
lȋtovsko	/líːtɔʋskɔ/
lítovščina	/lìːtɔʋʃt͡ʃina/
liturgȋja	/liturɡíːja/
Lȋtva	/líːtʋa/
lízati	/lìːzati/
Lizbọ̑na	/lizbóːna/
klobučár	/klɔbut͡ʃàːr/
rẹ̑d	/réːt/
do	/dÉ”/
vratȉč	/ʋratít͡ʃ/
otáva	/ɔtàːʋa/
slȁb	/sláp/
zgréšiti	/zɡrɛ̀ːʃiti/
vółga	/ʋɔ̀ːʋɡa/
čẹ́maž	/t͡ʃèːmaʃ/
se	/sɛ/
odrešeník	/ɔdrɛʃɛnìːk/
gáms	/ɡàːms/
lẹ́šnik	/lèːʃnik/
vọ̑jvodina	/ʋóːjʋɔdina/
mīrna Bọ̑sna	/mìːrna bóːsna/
dóbro jútro	/dɔ̀ːbrɔ jùːtrɔ/
diják	/dijàːk/
podgána	/pɔdɡàːna/
medeníca	/mɛdɛnìːt͡sa/
kẹ́lih	/kèːlix/
ljubȅč	/ljubɛ́t͡ʃ/
ljubẹ̑zən	/ljubéːzən/
ljúbit	/ljùːbit/
ljubīti	/ljubìːti/
Ljubljána	/ljubljàːna/
ljūbljenje	/ljùːbljɛnjɛ/
ljubosúmən	/ljubɔsùːmən/
ljubosúmnejši	/ljubɔsùːmnɛjʃi/
ljubosúmnost	/ljubɔsùːmnɔst/
ljȗdski	/ljúːtski/
lobánja	/lɔbàːnja/
ločeváti	/lɔt͡ʃɛʋàːti/
ločīti	/lɔt͡ʃìːti/
lọ̑g	/lóːk/
lọ̑k	/lóːk/
lokácija	/lɔkàːt͡sija/
lọ̑kativ	/lóːkatiʋ/
lokomotȋva	/lɔkɔmɔtíːʋa/
lȍm	/lɔ́m/
Lombardȋja	/lɔmbardíːja/
lomīti	/lɔmìːti/
lónəc	/lɔ̀ːnət͡s/
lopáta	/lɔpàːta/
lọ̑pov	/lóːpɔʋ/
lọ̑s	/lóːs/
lọ̑sos	/lóːsɔs/
lọ̑tos	/lóːtɔs/
lóvəc	/lɔ̀ːʋət͡s/
lovīti	/lɔʋìːti/
lȗbenica	/lúːbɛnit͡sa/
lúbje	/lùːbjɛ/
lūč	/lùːt͡ʃ/
lūg	/lùːk/
lúka	/lùːka/
Lúka	/lùːka/
lȗknja	/lúːknja/
Lȗksemburg	/lúːksɛmburk/
lȗksemburški	/lúːksɛmburʃki/
lȗlčək	/lúːlt͡ʃək/
lúna	/lùːna/
Lúna	/lùːna/
lunȃrən	/lunáːrən/
lúska	/lùːska/
lutẹ́cij	/lutèːt͡sij/
luterȃnəc	/lutɛráːnət͡s/
máčeha	/màːt͡ʃɛxa/
máčək	/màːt͡ʃək/
mȃčka	/máːt͡ʃka/
Madžȃrska	/mad͡ʒáːrska/
madžȃrščina	/mad͡ʒáːrʃt͡ʃina/
máfija	/màːfija/
magnẹ̑zij	/maɡnéːzij/
mȃh	/máːx/
máj	/màːj/
Mája	/màːja/
majáti	/majàːti/
mȃjhən	/máːjxən/
majonẹ̑za	/majɔnéːza/
majọ̑rka	/majóːrka/
mȁk	/mák/
Makedọ̑nəc	/makɛdóːnət͡s/
Makedọ́nija	/makɛdòːnija/
makedọ̑nski	/makɛdóːnski/
makedọ̑nščina	/makɛdóːnʃt͡ʃina/
maklȅn	/maklɛ́n/
malárija	/malàːrija/
Maldȋvi	/maldíːʋi/
Malẹ́zija	/malèːzija/
malína	/malìːna/
málo	/màːlɔ/
Mȃlta	/máːlta/
Mȃlte	/máːltɛ/
maltẹ̑ščina	/maltéːʃt͡ʃina/
maltẹ̑ško	/maltéːʃkɔ/
Maltežȁn	/maltɛʒán/
Maltežȃnka	/maltɛʒáːnka/
Mȃlti	/máːlti/
Mȃlto	/máːltɔ/
mamílo	/mamìːlɔ/
mȃmut	/máːmut/
mandolȋna	/mandɔlíːna/
mangȃn	/manɡáːn/
mȃnjkati	/máːnkati/
manjšȃlnica	/manʃáːlnit͡sa/
mȃnjši	/máːnʃi/
márəc	/màːrət͡s/
marẹ̑lica	/maréːlit͡sa/
Márko	/màːrkɔ/
Marọ̑ko	/maróːkɔ/
Mȃrs	/máːrs/
mȃsa	/máːsa/
máslo	/màːslɔ/
masturbácija	/masturbàːt͡sija/
máša	/màːʃa/
Matȇj	/matɛ́ːj/
matemátika	/matɛmàːtika/
mȃternica	/máːtɛrnit͡sa/
máti	/màːti/
mȃtica	/máːtit͡sa/
mẹ̑	/méː/
mȅč	/mɛ́t͡ʃ/
med	/mɛt/
medẹ̑n	/mɛdéːn/
medeníca	/mɛdɛnìːt͡sa/
medicȋna	/mɛdit͡síːna/
médved	/mɛ̀ːdʋɛt/
medvẹ̑dka	/mɛdʋéːtka/
mẹ̑ga-	/méːɡa-/
məglíca	/məɡlìːt͡sa/
mẹ̑h	/méːx/
meháničən	/mɛxàːnit͡ʃən/
Mẹ̑hika	/méːxika/
mehkȗžəc	/mɛxkúːʒət͡s/
mehúr	/mɛxùːr/
méja	/mɛ̀ːja/
mejīti	/mɛjìːti/
Mẹ́ka	/mèːka/
melancȃna	/mɛlant͡sáːna/
melodȋja	/mɛlɔdíːja/
mendelẹ́vij	/mɛndɛlèːʋij/
mẹ́njati	/mèːnjati/
merjásəc	/mɛrjàːsət͡s/
Merkȗr	/mɛrkúːr/
mesár	/mɛsàːr/
mẹ̑səc	/méːsət͡s/
Mẹ̑səc	/méːsət͡s/
Mesȋja	/mɛsíːja/
mesọ̑	/mɛsóː/
mesojẹ̑dəc	/mɛsɔjéːdət͡s/
mésti	/mɛ̀ːsti/
mẹ̑stnik	/méːstnik/
mẹ́sto	/mèːstɔ/
mẹ́šati	/mèːʃati/
mȅt	/mɛ́t/
mẹ̑ta	/méːta/
metafízika	/mɛtafìːzika/
metáti	/mɛtàːti/
mẹ̑tež	/méːtɛʃ/
mẹ́ti	/mèːti/
métla	/mɛ̀ːtla/
metúlj	/mɛtùːl/
məzə̏g	/məzə́k/
mezȋnəc	/mɛzíːnət͡s/
Míha	/mìːxa/
Mȋhaela	/míːxaɛla/
mȋl	/míːl/
milȋčnica	/milíːt͡ʃnit͡sa/
milimẹ́tər	/milimèːtər/
mȋlisekȗnda	/míːlisɛkúːnda/
mīliti	/mìːliti/
mílo	/mìːlɔ/
mȋna	/míːna/
mineralogȋja	/minɛralɔɡíːja/
mȋr	/míːr/
mīrna Bọ̑sna	/mìːrna bóːsna/
mísliti	/mìːsliti/
mȋšica	/míːʃit͡sa/
mȋšičən	/míːʃit͡ʃən/
mȋšjak	/míːʃjak/
míti	/mìːti/
mitologȋja	/mitɔlɔɡíːja/
mitolọ̑ški	/mitɔlóːʃki/
míza	/mìːza/
mizantropȋja	/mizantrɔpíːja/
klobučár	/klɔbut͡ʃàːr/
rẹ̑d	/réːt/
do	/dÉ”/
vratȉč	/ʋratít͡ʃ/
otáva	/ɔtàːʋa/
slȁb	/sláp/
zgréšiti	/zɡrɛ̀ːʃiti/
vółga	/ʋɔ̀ːʋɡa/
čẹ́maž	/t͡ʃèːmaʃ/
se	/sɛ/
odrešeník	/ɔdrɛʃɛnìːk/
gáms	/ɡàːms/
lẹ́šnik	/lèːʃnik/
vọ̑jvodina	/ʋóːjʋɔdina/
mīrna Bọ̑sna	/mìːrna bóːsna/
dóbro jútro	/dɔ̀ːbrɔ jùːtrɔ/
diják	/dijàːk/
podgána	/pɔdɡàːna/
medeníca	/mɛdɛnìːt͡sa/
kẹ́lih	/kèːlix/
Mjanmȃr	/mjanmáːr/
mladȉč	/mladít͡ʃ/
mladína	/mladìːna/
mlȃjša kamẹ̑na dóba	/mláːjʃa kaméːna dɔ̀ːba/
mlȃjši	/mláːjʃi/
mlẹ́sti	/mlèːsti/
množína	/mnɔʒìːna/
mọ́ča	/mòːt͡ʃa/
močerȁd	/mɔt͡ʃɛrát/
móči	/mɔ̀ːt͡ʃi/
močvȋrje	/mɔt͡ʃʋíːrjɛ/
mọ́dər	/mòːdər/
modernizȋrati	/mɔdɛrnizíːrati/
mọ̄do	/mòːdɔ/
mọ́drost	/mòːdrɔst/
mogọ́če	/mɔɡòːt͡ʃɛ/
Mọ́hamed	/mòːxamɛt/
Móhar	/mɔ̀ːxar/
Mọ̑jzes	/móːjzɛs/
mọ́kər	/mòːkər/
Moldávija	/mɔldàːʋija/
molȋtəv	/mɔlíːtəʋ/
molīti	/mɔlìːti/
mółsti	/mɔ̀ːʋsti/
monoteízəm	/mɔnɔtɛìːzəm/
mọ̑rati	/móːrati/
Morávəc	/mɔràːʋət͡s/
morīti	/mɔrìːti/
mornȃrica	/mɔrnáːrit͡sa/
mornárka	/mɔrnàːrka/
mórski	/mɔ̀ːrski/
mórski pə̏s	/mɔ̀ːrski pə́s/
Mọ̑skva	/móːskʋa/
mọ̑st	/móːst/
mȍšt	/mɔ́ʃt/
motȋka	/mɔtíːka/
mọ̑tor	/móːtɔr/
mọ́žən	/mòːʒən/
možgȃni	/mɔʒɡáːni/
mọ́žnost	/mòːʒnɔst/
mrāvlja	/mràːʋlja/
mrẹ́ti	/mrèːti/
mrẹ́ža	/mrèːʒa/
mrhovína	/mərxɔʋìːna/
mŕkəv	/mə̀rkəʋ/
mŕkva	/mə̀rkʋa/
mrọ̑ž	/mróːʃ/
mŕtəv	/mə̀rtəʋ/
Mŕtvo mọ̑rje	/mə̀rtʋɔ móːrjɛ/
mudīti	/mudìːti/
muflọ̑n	/muflóːn/
múha	/mùːxa/
mujezȋn	/mujɛzíːn/
múla	/mùːla/
mȗngo	/múːnɡɔ/
mȗrva	/múːrʋa/
muskulȃrən	/muskuláːrən/
muslimȃn	/muslimáːn/
muslimȃnka	/muslimáːnka/
muslimȃnski	/muslimáːnski/
mȗšnica	/múːʃnit͡sa/
muzȇj	/muzɛ́ːj/
muzikȃlən	/muzikáːlən/
muzikologȋja	/muzikɔlɔɡíːja/
na	/na/
na-	/na-/
načélo	/nat͡ʃɛ̀ːlɔ/
načẹ́ti	/nat͡ʃèːti/
načȓt	/nat͡ʃə́rt/
nad	/nat/
nad-	/nad-/
nadlegováti	/nadlɛɡɔʋàːti/
nadporọ̑čnica	/natpɔróːt͡ʃnit͡sa/
nadzorováti	/nadzɔrɔʋàːti/
naénkrat	/naɛ̀ːnkrat/
nȃfta	/náːfta/
nȃg	/náːk/
nágəlj	/nàːɡəl/
nȁj-	/nàj/
nȁjabsȗrdnejši	/nájapsúːrdnɛjʃi/
nȁjbelȇjši	/nájbɛlɛ́ːjʃi/
nȁjbetẹ́žnejši	/nájbɛtèːʒnɛjʃi/
nȁjbogatȇjši	/nájbɔɡatɛ́ːjʃi/
nȁjbọ̑ljši	/nájbóːlʃi/
nȁjbúdnejši	/nájbùːdnɛjʃi/
nȁjdȁlj	/nájdál/
nȁjdȃljši	/nájdáːlʃi/
nȁjdolgočásnejši	/nájdɔlɡɔt͡ʃàːsnɛjʃi/
nȁjdrȃžji	/nájdráːʒji/
nȁjglasnȇjši	/nájɡlasnɛ́ːjʃi/
nȁjglȗšji	/nájɡlúːʃji/
nȁjgȓji	/nájɡə́rji/
nȁjgrozljívejši	/nájɡrɔzljìːʋɛjʃi/
nȁjhitréje	/nájxitrɛ̀ːjɛ/
nȁjhitréjše	/nájxitrɛ̀ːjʃɛ/
nȁjhȗjši	/nájxúːjʃi/
nȁjjásnejši	/nájjàːsnɛjʃi/
nȁjjẹ́znejši	/nájjèːznɛjʃi/
nȁjkrȃjši	/nájkráːjʃi/
nȁjkrūtejši	/nájkrùːtɛjʃi/
nȁjlȃžji	/nájláːʒji/
nȁjljubosúmnejši	/nájljubɔsùːmnɛjʃi/
nȁjmȃnjši	/nájmáːnʃi/
nȁjmẹ̑čji	/nájméːt͡ʃji/
nȁjmlȃjši	/nájmláːjʃi/
nȁjmodrȇjši	/nájmɔdrɛ́ːjʃi/
nȁjnȅpotrpežljívejši	/nájnɛ́pɔtərpɛʒljìːʋɛjʃi/
nȁjneúmnejši	/nájnɛùːmnɛjʃi/
nȁjobčutljívejši	/nájɔpt͡ʃutljìːʋɛjʃi/
nȁjočítnejši	/nájɔt͡ʃìːtnɛjʃi/
nȁjokúsnejši	/nájɔkùːsnɛjʃi/
nȁjosnȏvnejši	/nájɔsnɔ́ːʋnɛjʃi/
nȁjọ̑žji	/nájóːʒji/
nȁjpẹ́strejši	/nájpèːstrɛjʃi/
nȁjplọ́dnejši	/nájplòːdnɛjʃi/
nȁjpočásneje	/nájpɔt͡ʃàːsnɛjɛ/
nȁjpódlejši	/nájpɔ̀ːdlɛjʃi/
nȁjpodọ́bnejši	/nájpɔdòːbnɛjʃi/
nȁjpodrọ̑bnejši	/nájpɔdróːbnɛjʃi/
nȁjpogọ̑steje	/nájpɔɡóːstɛjɛ/
nȁjpogọ̑stejše	/nájpɔɡóːstɛjʃɛ/
nȁjpogúmnejši	/nájpɔɡùːmnɛjʃi/
nȁjpólnejši	/nájpɔ̀ːlnɛjʃi/
nȁjpomẹ̄mbnejši	/nájpɔmèːmbnɛjʃi/
nȁjpotrẹ́bnejši	/nájpɔtrèːbnɛjʃi/
nȁjpotrpežljívejši	/nájpɔtərpɛʒljìːʋɛjʃi/
nȁjpravȋlneje	/nájpraʋíːlnɛjɛ/
nȁjpravȋlnejše	/nájpraʋíːlnɛjʃɛ/
nȁjprídnejši	/nájprìːdnɛjʃi/
nȁjpustȇjši	/nájpustɛ́ːjʃi/
nȁjránejši	/nájràːnɛjʃi/
nȁjrávnejši	/nájràːʋnɛjʃi/
nȁjredkȇjši	/nájrɛtkɛ́ːjʃi/
nȁjresnīčnejši	/nájrɛsnìːt͡ʃnɛjʃi/
nȁjrẹ́vnejši	/nájrèːʋnɛjʃi/
nȁjskrȋvnejši	/nájskríːʋnɛjʃi/
nȁjskrivnọ̑stnejši	/nájskriʋnóːstnɛjʃi/
nȁjslȃbše	/nájsláːpʃɛ/
nȁjslȃbši	/nájsláːpʃi/
nȁjsladȇjši	/nájsladɛ́ːjʃi/
nȁjslȃjši	/nájsláːjʃi/
nȁjsmẹ́lejši	/nájsmèːlɛjʃi/
nȁjsodóbnejši	/nájsɔdɔ̀ːbnɛjʃi/
nȁjsọ̑nčnejši	/nájsóːnt͡ʃnɛjʃi/
nȁjsplóšnejši	/nájsplɔ̀ːʃnɛjʃi/
nȁjspodọ́bnejši	/nájspɔdòːbnɛjʃi/
nȁjsrẹ́čnejše	/nájsrèːt͡ʃnɛjʃɛ/
nȁjsrẹ́čnejši	/nájsrèːt͡ʃnɛjʃi/
nȁjstarȇjši	/nájstarɛ́ːjʃi/
klobučár	/klɔbut͡ʃàːr/
rẹ̑d	/réːt/
do	/dÉ”/
vratȉč	/ʋratít͡ʃ/
otáva	/ɔtàːʋa/
slȁb	/sláp/
zgréšiti	/zɡrɛ̀ːʃiti/
vółga	/ʋɔ̀ːʋɡa/
čẹ́maž	/t͡ʃèːmaʃ/
se	/sɛ/
odrešeník	/ɔdrɛʃɛnìːk/
gáms	/ɡàːms/
lẹ́šnik	/lèːʃnik/
vọ̑jvodina	/ʋóːjʋɔdina/
mīrna Bọ̑sna	/mìːrna bóːsna/
dóbro jútro	/dɔ̀ːbrɔ jùːtrɔ/
diják	/dijàːk/
podgána	/pɔdɡàːna/
medeníca	/mɛdɛnìːt͡sa/
kẹ́lih	/kèːlix/
nȁjstrástnejši	/nájstràːstnɛjʃi/
nȁjsvobódnejši	/nájsʋɔbɔ̀ːdnɛjʃi/
nȁjtẹ̑žji	/nájtéːʒji/
nájti	/nàːjti/
nȁjtȓši	/nájtə́rʃi/
nȁjusọ́dnejši	/nájusòːdnɛjʃi/
nȁjustrẹ́znejši	/nájustrèːznɛjʃi/
nȁjvárnejši	/nájʋàːrnɛjʃi/
nȁjveč	/nájʋɛt͡ʃ/
nȁjvẹ̑čji	/nájʋéːt͡ʃji/
nȁjvȋšja kȃrta	/nájʋíːʃja káːrta/
nȁjvȋšji	/nájʋíːʃji/
nȁjzanimívejši	/nájzanimìːʋɛjʃi/
nȁjznačȋlnejši	/nájznat͡ʃíːlnɛjʃi/
nȁjživáhnejši	/nájʒiʋàːxnɛjʃi/
nakljȗčje	/nakljúːt͡ʃjɛ/
namenȋlnik	/namɛníːlnik/
namẹ̑ra	/naméːra/
Namíbija	/namìːbija/
namigováti	/namiɡɔʋàːti/
nanȃšati	/nanáːʃati/
nanosīti	/nanɔsìːti/
napȃčən	/napáːt͡ʃən/
napȁd	/napát/
napȃka	/napáːka/
napísati	/napìːsati/
naprȃva	/napráːʋa/
narȃva	/naráːʋa/
narávən	/naràːʋən/
narávnejši	/naràːʋnɛjʃi/
narẹ̑čje	/naréːt͡ʃjɛ/
naslẹ̑dnji	/nasléːdnji/
nasmȅh	/nasmɛ́x/
nasmẹ́hniti	/nasmèːxniti/
nastáti	/nastàːti/
nȁš	/náʃ/
Natȃša	/natáːʃa/
nátrij	/nàːtrij/
navdȋh	/naʋdíːx/
nazáj	/nazàːj/
nȅ	/nɛ́/
Neápəlj	/nɛàːpəl/
nebẹ́sa	/nɛbèːsa/
nebọ̑	/nɛbóː/
nebotȋčnik	/nɛbɔtíːt͡ʃnik/
nedẹ́lja	/nɛdèːlja/
nȅdolọ̄čnik	/nɛ́dɔlòːt͡ʃnik/
nẹ̑hati	/néːxati/
nẹ̄kaj	/nèːkaj/
nẹ́kam	/nèːkam/
nekdọ̄	/nɛɡdòː/
nekjẹ̄	/nɛkjèː/
nekrofilȋja	/nɛkrɔfilíːja/
nekrọ̑pola	/nɛkróːpɔla/
nẹ̑m	/néːm/
Nẹ̑mčija	/néːmt͡ʃija/
Nẹ́məc	/nèːmət͡s/
Nẹ́mka	/nèːmka/
nȅmogọ́č	/nɛ́mɔɡòːt͡ʃ/
nẹ́mščina	/nèːmʃt͡ʃina/
nẹ́mški	/nèːmʃki/
nẹ́mški ovčár	/nèːmʃki ɔʋt͡ʃàːr/
nẹ́mško	/nèːmʃkɔ/
neodȋm	/nɛɔdíːm/
nȅodvísən	/nɛ́ɔdʋìːsən/
nẹ̑on	/néːɔn/
nȅposrẹ̑dən	/nɛ́pɔsréːdən/
nȅposrẹ̑dno	/nɛ́pɔsréːdnɔ/
nȅpotrpežljīv	/nɛ́pɔtərpɛʒljìːʋ/
nȅpredvidljīv	/nɛ́prɛdʋidljìːʋ/
neptúnij	/nɛptùːnij/
nésti	/nɛ̀ːsti/
netopīr	/nɛtɔpìːr/
nevȋhta	/nɛʋíːxta/
neznáni letẹ́či prédmet	/nɛznàːni lɛtèːt͡ʃi prɛ̀ːdmɛt/
nȉ vsȅ zlatọ̑, kȁr se svẹ́ti	/ní ʋsɛ́ zlatóː, kár sɛ sʋèːti/
nȉč	/nít͡ʃ/
nihčȅ	/nixt͡ʃɛ́/
Nikolȃj	/nikɔláːj/
nikọ̑li	/nikóːli/
niọ́bij	/nijòːbij/
nȉt	/nít/
nízək	/nìːzək/
Nizozẹ̑məc	/nizɔzéːmət͡s/
Nizozẹ̑mka	/nizɔzéːmka/
Nizozẹ̑mska	/nizɔzéːmska/
nizozẹ̑mski	/nizɔzéːmski/
nizozẹ̑msko	/nizɔzéːmskɔ/
nizozẹ̑mščina	/nizɔzéːmʃt͡ʃina/
njegóv	/njɛɡɔ̀ːʋ/
njẹ́n	/njèːn/
njīhov	/njìːxɔʋ/
njún	/njùːn/
NLP	/nələpə́/
nobẹ́lij	/nɔbèːlij/
nocọ́j	/nɔt͡sòːj/
nọ̑č	/nóːt͡ʃ/
nóga	/nɔ̀ːɡa/
nogavíca	/nɔɡaʋìːt͡sa/
nogomȅt	/nɔɡɔmɛ́t/
nọ̑ht	/nóːxt/
nọ̑j	/nóːj/
nọ̑minativ	/nóːminatiʋ/
nȍr	/nɔ́r/
norvẹ̑ščina	/nɔrʋéːʃt͡ʃina/
Norvẹ̑ška	/nɔrʋéːʃka/
norvẹ̑ško	/nɔrʋéːʃkɔ/
Norvežȃnka	/nɔrʋɛʒáːnka/
nọ̑s	/nóːs/
nosȋləc	/nɔsíːlət͡s/
nosorọ̑g	/nɔsɔróːk/
nọ̑ta	/nóːta/
nọ̄ter	/nòːtɛr/
nọ̄tri	/nòːtri/
nȍv	/nɔ́ʋ/
Nóva Goríca	/nɔ̀ːʋa ɡɔrìːt͡sa/
Nóva Zelándija	/nɔ̀ːʋa zɛlàːndija/
Novák	/nɔʋàːk/
novémbər	/nɔʋɛ̀ːmbər/
novína	/nɔʋìːna/
novȋnəc	/nɔʋíːnət͡s/
Nóvo mẹ́sto	/nɔ̀ːʋɔ mèːstɔ/
nȍž	/nɔ́ʃ/
núna	/nùːna/
o-	/ɔ-/
občȋnstvo	/ɔpt͡ʃíːnstʋɔ/
občutljīv	/ɔpt͡ʃutljìːʋ/
občutljívejši	/ɔpt͡ʃutljìːʋɛjʃi/
obȅd	/ɔbɛ́t/
obẹ́siti	/ɔbèːsiti/
obiskáti	/ɔbiskàːti/
obiskováti	/ɔbiskɔʋàːti/
objáviti	/ɔbjàːʋiti/
objȅm	/ɔbjɛ́m/
objẹ́ti	/ɔbjèːti/
oblȃk	/ɔbláːk/
oblȃst	/ɔbláːst/
oblẹ̑ka	/ɔbléːka/
oblȋka	/ɔblíːka/
oblikoslȏvən	/ɔblikɔslɔ́ːʋən/
obmọ̑dək	/ɔbmóːdək/
ọ̑boa	/óːbɔa/
obrȃmba	/ɔbráːmba/
obranīti	/ɔbranìːti/
obrȁz	/ɔbrás/
obrȃzən	/ɔbráːzən/
obrazílo	/ɔbrazìːlɔ/
obrezovánje	/ɔbrɛzɔʋàːnjɛ/
obȓv	/ɔbə́rʋ/
obsẹ̑čnica	/ɔpséːt͡ʃnit͡sa/
obúti	/ɔbùːti/
óče	/ɔ̀ːt͡ʃɛ/
ọ̄čim	/òːt͡ʃim/
očítnejši	/ɔt͡ʃìːtnɛjʃi/
od	/ɔt/
od-	/ɔd-/
odȇja	/ɔdɛ́ːja/
ọ́dər	/òːdər/
odgȏvor	/ɔdɡɔ́ːʋɔr/
odgovorīti	/ɔdɡɔʋɔrìːti/
odjáviti	/ɔdjàːʋiti/
odlíčnejši	/ɔdlìːt͡ʃnɛjʃi/
odlọ̑čba	/ɔdlóːd͡ʒba/
odnȍs	/ɔdnɔ́s/
odprẹ́ti	/ɔtprèːti/
odrešeník	/ɔdrɛʃɛnìːk/
odvísən	/ɔdʋìːsən/
odvrẹ́ti	/ɔdʋrèːti/
ógənj	/ɔ̀ːɡən/
klobučár	/klɔbut͡ʃàːr/
rẹ̑d	/réːt/
do	/dÉ”/
vratȉč	/ʋratít͡ʃ/
otáva	/ɔtàːʋa/
slȁb	/sláp/
zgréšiti	/zɡrɛ̀ːʃiti/
vółga	/ʋɔ̀ːʋɡa/
čẹ́maž	/t͡ʃèːmaʃ/
se	/sɛ/
odrešeník	/ɔdrɛʃɛnìːk/
gáms	/ɡàːms/
lẹ́šnik	/lèːʃnik/
vọ̑jvodina	/ʋóːjʋɔdina/
mīrna Bọ̑sna	/mìːrna bóːsna/
dóbro jútro	/dɔ̀ːbrɔ jùːtrɔ/
diják	/dijàːk/
podgána	/pɔdɡàːna/
medeníca	/mɛdɛnìːt͡sa/
kẹ́lih	/kèːlix/
oglȁs	/ɔɡlás/
ogledálo	/ɔɡlɛdàːlɔ/
ogljȋk	/ɔɡljíːk/
ognjeník	/ɔɡnjɛnìːk/
ogọ̑r	/ɔɡóːr/
ogrāja	/ɔɡràːja/
ogrozīti	/ɔɡrɔzìːti/
ogrọ́žati	/ɔɡròːʒati/
Ọ̄grska	/òːɡərska/
ojẹ̑	/ɔjéː/
okarȋna	/ɔkaríːna/
oklepȃj	/ɔklɛpáːj/
ókno	/ɔ̀ːknɔ/
okọ̑	/ɔkóː/
okọ́pati	/ɔkòːpati/
okopȃvati	/ɔkɔpáːʋati/
okọ̑stje	/ɔkóːstjɛ/
okrọ́gəł	/ɔkròːɡəʋ/
oktọ́bər	/ɔktòːbər/
okȗs	/ɔkúːs/
okúsən	/ɔkùːsən/
okúsnejši	/ɔkùːsnɛjʃi/
ọ̑l	/óːl/
ọ́lje	/òːljɛ/
ọ̑man	/óːman/
ȍn	/ɔ́n/
óna	/ɔ̀ːna/
óne	/ɔ̀ːnɛ/
óni	/ɔ̀ːni/
óno	/ɔ̀ːnɔ/
opȃt	/ɔpáːt/
opatȋja	/ɔpatíːja/
opazováti	/ɔpazɔʋàːti/
opẹ̑ka	/ɔpéːka/
opeklína	/ɔpɛklìːna/
operẹ̑ta	/ɔpɛréːta/
oporọ̑ka	/ɔpɔróːka/
oprostȋte	/ɔprɔstíːtɛ/
ọ́ptičən	/òːptit͡ʃən/
ọ́ptika	/òːptika/
opuščȃj	/ɔpuʃt͡ʃáːj/
orákəlj	/ɔràːkəl/
órəł	/ɔ̀ːrəʋ/
organizácija	/ɔrɡanizàːt͡sija/
orgázəm	/ɔrɡàːzəm/
orgázmičən	/ɔrɡàːzmit͡ʃən/
orgiástičən	/ɔrɡiàːstit͡ʃən/
ọ̑rgle	/óːrɡlɛ/
orhidȇja	/ɔrxidɛ́ːja/
orják	/ɔrjàːk/
orlȉč	/ɔrlít͡ʃ/
orọ̑dje	/ɔróːdjɛ/
orọ̑dnik	/ɔróːdnik/
ọ̑s	/óːs/
ósa	/ɔ̀ːsa/
osẹ̑ba	/ɔséːba/
osẹ̑bən	/ɔséːbən/
osẹ̑bnost	/ɔséːbnɔst/
	
ọ́səm	/òːsəm/
ọ́səmdeset	/òːsəmdɛsɛt/
osəmnájst	/ɔsəmnàːjst/
ọ́smij	/òːsmij/
osnȏvən	/ɔsnɔ́ːʋən/
osnȏvna interákcija	/ɔsnɔ́ːʋna intɛràːkt͡sija/
osnȏvna síla	/ɔsnɔ́ːʋna sìːla/
osnȏvnejši	/ɔsnɔ́ːʋnɛjʃi/
osọ̑nčje	/ɔsóːnt͡ʃjɛ/
-ost	/-ɔst/
ọ̑st	/óːst/
ọ́stər	/òːstər/
ostrīga	/ɔstrìːɡa/
ostrȋvəc	/ɔstríːʋət͡s/
ošíliti	/ɔʃìːliti/
otáva	/ɔtàːʋa/
otẹ́ti	/ɔtèːti/
ótok	/ɔ̀ːtɔk/
otomȃnski	/ɔtɔmáːnski/
otročȅ	/ɔtrɔt͡ʃɛ́/
otrọ́čji	/ɔtròːt͡ʃji/
otrȍk	/ɔtrɔ́k/
otŕpniti	/ɔtə̀rpniti/
otvọ̄riti	/ɔtʋòːriti/
-ováti	/-ɔʋàːti/
óvca	/ɔ̀ːʋt͡sa/
ovčár	/ɔʋt͡ʃàːr/
óvən	/ɔ̀ːʋən/
óvəs	/ɔ̀ːʋəs/
ovrȃtnik	/ɔʋráːtnik/
ọ́zək	/òːzək/
ozȋroma	/ɔzíːrɔma/
oznȃka	/ɔznáːka/
ožẹ̑mati	/ɔʒéːmati/
ožẹ́ti	/ɔʒèːti/
ọ̑žji	/óːʒji/
pa	/pa/
padálo	/padàːlɔ/
pādati	/pàːdati/
pȃdəc	/páːdət͡s/
páglavəc	/pàːɡlaʋət͡s/
pȃjək	/páːjək/
paláča	/palàːt͡ʃa/
paládij	/palàːdij/
paladȋn	/paladíːn/
pȃłčnik	/páːʋt͡ʃnik/
pȃləc	/páːlət͡s/
paleolítik	/palɛɔlìːtik/
Palestȋna	/palɛstíːna/
palimpsẹ̑st	/palimpséːst/
palindrọ̑m	/palindróːm/
pȃlma	/páːlma/
pámet	/pàːmɛt/
pȃnj	/páːn/
papagȃj	/papaɡáːj/
pȃpež	/páːpɛʃ/
pȃpiga	/páːpiɡa/
papȋr	/papíːr/
Pȃpua Nóva Gvinȇja	/páːpua nɔ̀ːʋa ɡʋinɛ́ːja/
pár	/pàːr/
paradȋžnik	/paradíːʒnik/
paradọ̑ks	/paradóːks/
paranọ̑ja	/paranóːja/
parfȗm	/parfúːm/
Parȋz	/paríːs/
pȃst	/páːst/
pásti	/pàːsti/
pastír	/pastìːr/
patologȋja	/patɔlɔɡíːja/
patolọ̑ški	/patɔlóːʃki/
pȃv	/páːʋ/
Pȃvəl	/páːʋəl/
pȃzduha	/páːzduxa/
Pȇarl Hȃrbor	/pɛ́ːrl xáːrbɔr/
pẹ̑č	/péːt͡ʃ/
pečȃt	/pɛt͡ʃáːt/
péči	/pɛ̀ːt͡ʃi/
pedagọ́gika	/pɛdaɡòːɡika/
pegȃtka	/pɛɡáːtka/
pəháti	/pəxàːti/
pẹ̄k	/pèːk/
pəkə̏l	/pəkə́ʋ/
peljáti	/pɛljàːti/
pẹ́na	/pèːna/
pẹ̑nis	/péːnis/
pepẹ̑ł	/pɛpéːʋ/
Pepẹ̑lka	/pɛpéːlka/
perọ̑	/pɛróː/
perọ̑n	/pɛróːn/
perȗt	/pɛrúːt/
perutnína	/pɛrutnìːna/
pervérzija	/pɛrʋɛ̀ːrzija/
pə̏s	/pə́s/
pẹ́sək	/pèːsək/
pẹ̑səm	/péːsəm/
pẹ̑snik	/péːsnik/
pẹ̑st	/péːst/
pẹ́stər	/pèːstər/
pestȉč	/pɛstít͡ʃ/
pẹ́strejši	/pèːstrɛjʃi/
pẹ̑t	/péːt/
péta	/pɛ̀ːta/
pẹ̑tdeset	/péːddɛsɛt/
pẹ́tək	/pèːtək/
petélin	/pɛtɛ̀ːlin/
Pẹ́tər	/pèːtər/
peteršȉlj	/pɛtɛrʃíl/
péti	/pɛ̀ːti/
petnájst	/pɛtnàːjst/
pẹ́vəc	/pèːʋət͡s/
pháti	/pxàːti/
pȋ	/píː/
pianȋst	/pijaníːst/
pīca	/pìːt͡sa/
píhati	/pìːxati/
pijáča	/pijàːt͡ʃa/
pijȃvka	/pijáːʋka/
pikapolọ̑nica	/pikapɔlóːnit͡sa/
píla	/pìːla/
pingvȋn	/pinɡʋíːn/
pípa	/pìːpa/
píra	/pìːra/
piramȋda	/piramíːda/
pisȃrna	/pisáːrna/
pisȃtelj	/pisáːtɛl/
písati	/pìːsati/
písmo	/pìːsmɔ/
pistácija	/pistàːt͡sija/
piščánəc	/piʃt͡ʃàːnət͡s/
píta	/pìːta/
klobučár	/klɔbut͡ʃàːr/
rẹ̑d	/réːt/
do	/dÉ”/
vratȉč	/ʋratít͡ʃ/
otáva	/ɔtàːʋa/
slȁb	/sláp/
zgréšiti	/zɡrɛ̀ːʃiti/
vółga	/ʋɔ̀ːʋɡa/
čẹ́maž	/t͡ʃèːmaʃ/
se	/sɛ/
odrešeník	/ɔdrɛʃɛnìːk/
gáms	/ɡàːms/
lẹ́šnik	/lèːʃnik/
vọ̑jvodina	/ʋóːjʋɔdina/
mīrna Bọ̑sna	/mìːrna bóːsna/
dóbro jútro	/dɔ̀ːbrɔ jùːtrɔ/
diják	/dijàːk/
podgána	/pɔdɡàːna/
medeníca	/mɛdɛnìːt͡sa/
kẹ́lih	/kèːlix/
Pitágora	/pitàːɡɔra/
píti	/pìːti/
pitọ̑n	/pitóːn/
pívo	/pìːʋɔ/
pīzda	/pìːzda/
pláčati	/plàːt͡ʃati/
plámen	/plàːmɛn/
planẹ̑t	/planéːt/
plášč	/plàːʃt͡ʃ/
platȃna	/platáːna/
plȃtina	/pláːtina/
plátno	/plàːtnɔ/
plȃvati	/pláːʋati/
plȃz	/pláːs/
pláža	/plàːʒa/
plẹ̑s	/pléːs/
plẹ́sati	/plèːsati/
plẹ̑sən	/pléːsən/
plésti	/plɛ̀ːsti/
plẹ́ti	/plèːti/
plẹ́va	/plèːʋa/
pljúča	/pljùːt͡ʃa/
pljȗčnica	/pljúːt͡ʃnit͡sa/
pločevȋnka	/plɔt͡ʃɛʋíːnka/
plọ̑d	/plóːt/
plọ́dən	/plòːdən/
plọ́dnejši	/plòːdnɛjʃi/
plȗg	/plúːk/
plúta	/plùːta/
plúti	/plùːti/
Plȗton	/plúːtɔn/
plutọ́nij	/plutòːnij/
po	/pÉ”/
po-	/pɔ-/
pobráti	/pɔbràːti/
pocẹ́ni	/pɔt͡sèːni/
počȃsi	/pɔt͡ʃáːsi/
počásneje	/pɔt͡ʃàːsnɛjɛ/
počásno	/pɔt͡ʃàːsnɔ/
počȋtək	/pɔt͡ʃíːtək/
pọ́čiti	/pòːt͡ʃiti/
počívati	/pɔt͡ʃìːʋati/
pȍd	/pɔ́t/
pod-	/pɔd-/
podȃljšati	/pɔdáːlʃati/
podaljšȃva	/pɔdalʃáːʋa/
pódəł	/pɔ̀ːdəʋ/
podgána	/pɔdɡàːna/
pódkəv	/pɔ̀ːtkəʋ/
podkováti	/pɔtkɔʋàːti/
pódla	/pɔ̀ːdla/
podlásica	/pɔdlàːsit͡sa/
podlẹ́či	/pɔdlèːt͡ʃi/
pódlejši	/pɔ̀ːdlɛjʃi/
podmọ̑rnica	/pɔdmóːrnit͡sa/
podnẹ̑bje	/pɔdnéːbjɛ/
podọ̑ba	/pɔdóːba/
podọ́bən	/pɔdòːbən/
podọ́bnejši	/pɔdòːbnɛjʃi/
pȍdpȋčje	/pɔ́tpíːt͡ʃjɛ/
podrọ̑bən	/pɔdróːbən/
podrọ̑bnejši	/pɔdróːbnɛjʃi/
podrọ̑bnost	/pɔdróːbnɔst/
pofȗkan	/pɔfúːkan/
pofȗkati	/pɔfúːkati/
pogáča	/pɔɡàːt͡ʃa/
pogọ̑dba	/pɔɡóːdba/
pogȍj	/pɔɡɔ́j/
pogọ̑jnik	/pɔɡóːjnik/
pogółtniti	/pɔɡɔ̀ːʋtniti/
pogọ̑steje	/pɔɡóːstɛjɛ/
pogọ̑stejše	/pɔɡóːstɛjʃɛ/
pogọ̑sto	/pɔɡóːstɔ/
pogovȃrjati	/pɔɡɔʋáːrjati/
pogȏvor	/pɔɡɔ́ːʋɔr/
pogȏvorən	/pɔɡɔ́ːʋɔrən/
pogovorīti	/pɔɡɔʋɔrìːti/
pogrẹ́šati	/pɔɡrèːʃati/
pogȗm	/pɔɡúːm/
pogúmən	/pɔɡùːmən/
pogúmnejši	/pɔɡùːmnɛjʃi/
pohȋštvo	/pɔxíːʃtʋɔ/
Pọ̑horje	/póːxɔrjɛ/
pojāsniti	/pɔjàːsniti/
pojȗtrišnjem	/pɔjúːtriʃnjɛm/
pokázati	/pɔkàːzati/
pọ́kər	/pòːkər/
poklẹ́kniti	/pɔklèːkniti/
poklȋc	/pɔklíːt͡s/
poklícati	/pɔklìːt͡sati/
pokȍl	/pɔkɔ́l/
pokȍp	/pɔkɔ́p/
pokopalíšče	/pɔkɔpalìːʃt͡ʃɛ/
pokrȍv	/pɔkrɔ́ʋ/
pȏłbrȁt	/pɔ́ːʋbrát/
pȏłdan	/pɔ́ːʋdan/
polẹ́novka	/pɔlèːnɔʋka/
polẹ̑tje	/pɔléːtjɛ/
pōłh	/pɔ̀ːʋx/
políca	/pɔlìːt͡sa/
policȋst	/pɔlit͡síːst/
policȋstka	/pɔlit͡síːstka/
politeízəm	/pɔlitɛìːzəm/
polízati	/pɔlìːzati/
Polják	/pɔljàːk/
Poljákinja	/pɔljàːkinja/
Poljánšək	/pɔljàːnʃək/
pọ̑lje	/póːljɛ/
poljedẹ̑lstvo	/pɔljɛdéːlstʋɔ/
Pọ̑ljska	/póːlska/
pọ̑ljski	/póːlski/
pọ̑ljsko	/póːlskɔ/
pọ̑ljščina	/póːlʃt͡ʃina/
poljȗb	/pɔljúːp/
poljubīti	/pɔljubìːti/
polkȏvnica	/pɔlkɔ́ːʋnit͡sa/
połmẹ̑r	/pɔʋméːr/
pȏłn	/pɔ́ːʋn/
półnejši	/pɔ̀ːʋnɛjʃi/
pȏłnoč	/pɔ́ːʋnɔt͡ʃ/
polọ́nij	/pɔlòːnij/
pọ̑lotok	/póːlɔtɔk/
polovíca	/pɔlɔʋìːt͡sa/
položȃj	/pɔlɔʒáːj/
połzẹ́ti	/pɔʋzèːti/
pōłž	/pɔ̀ːʋʃ/
pomágati	/pɔmàːɡati/
pomarȃnča	/pɔmaráːnt͡ʃa/
pomẹ̄mbən	/pɔmèːmbən/
pomẹ̄mbnejši	/pɔmèːmbnɛjʃi/
pomẹ̄mbnost	/pɔmèːmbnɔst/
pomȅn	/pɔmɛ́n/
pomenoslȏvje	/pɔmɛnɔslɔ́ːʋjɛ/
pomẹ̑nski	/pɔméːnski/
pomlȃd	/pɔmláːt/
pọ̑mniti	/póːmniti/
pomọ̑č	/pɔmóːt͡ʃ/
pomočník	/pɔmɔt͡ʃnìːk/
ponaredīti	/pɔnarɛdìːti/
ponedẹ̑ljək	/pɔnɛdéːljək/
ponȍs	/pɔnɔ́s/
popȃčenka	/pɔpáːt͡ʃɛnka/
pọ̑pək	/póːpək/
pópər	/pɔ̀ːpər/
poplȃva	/pɔpláːʋa/
popȏłdan	/pɔpɔ́ːʋdan/
popȏłnoma	/pɔpɔ́ːʋnɔma/
pọ̑r	/póːr/
porcelȃn	/pɔrt͡sɛláːn/
pornogrȃf	/pɔrnɔɡráːf/
pornografȋja	/pɔrnɔɡrafíːja/
pornogrȃfski	/pɔrnɔɡráːfski/
poročȅn	/pɔrɔt͡ʃɛ́n/
poročílo	/pɔrɔt͡ʃìːlɔ/
porọ̑čnica	/pɔróːt͡ʃnit͡sa/
porọ̑čnik	/pɔróːt͡ʃnik/
porȍd	/pɔrɔ́t/
Portorȋko	/pɔrtɔríːkɔ/
portrẹ̑t	/pɔrtréːt/
Portugȃləc	/pɔrtuɡáːlət͡s/
Portugȃlka	/pɔrtuɡáːlka/
Portugȃlska	/pɔrtuɡáːlska/
portugȃlski	/pɔrtuɡáːlski/
portugȃlsko	/pɔrtuɡáːlskɔ/
portugȃlščina	/pɔrtuɡáːlʃt͡ʃina/
posȃmeznik	/pɔsáːmɛznik/
posẹ̑bej	/pɔséːbɛj/
pósəł	/pɔ̀ːsəʋ/
poskúsiti	/pɔskùːsiti/
poskúšati	/pɔskùːʃati/
posláti	/pɔslàːti/
poslōvno obvẹ́ščanje	/pɔslɔ̀ːʋnɔ ɔbʋèːʃt͡ʃanjɛ/
poslúšati	/pɔslùːʃati/
posnẹ̑to mlẹ́ko	/pɔsnéːtɔ mlèːkɔ/
posodīti	/pɔsɔdìːti/
posodōbiti	/pɔsɔdɔ̀ːbiti/
pospẹ̑šək	/pɔspéːʃək/
pȍst	/pɔ́st/
postȃja	/pɔstáːja/
postáti	/pɔstàːti/
pọ́stelja	/pòːstɛlja/
pọ́steljica	/pòːstɛljit͡sa/
postȓv	/pɔstə́rʋ/
pọ́t	/pòːt/
potegováti	/pɔtɛɡɔʋàːti/
potẹ̑m	/pɔtéːm/
pọ̑tni lȋst	/póːtni líːst/
pótok	/pɔ̀ːtɔk/
potrẹ́bən	/pɔtrèːbən/
potrẹ́bnejši	/pɔtrèːbnɛjʃi/
potrebováti	/pɔtrɛbɔʋàːti/
potrebȗjem tvójo pomọ̑č	/pɔtrɛbúːjɛm tʋɔ̀ːjɔ pɔmóːt͡ʃ/
potrebȗjem vášo pomọ̑č	/pɔtrɛbúːjɛm ʋàːʃɔ pɔmóːt͡ʃ/
potrȅs	/pɔtrɛ́s/
potrpežljīv	/pɔtərpɛʒljìːʋ/
potrpežljívejši	/pɔtərpɛʒljìːʋɛjʃi/
potrpežljívost	/pɔtərpɛʒljìːʋɔst/
poudáriti	/pɔudàːriti/
povẹ̑dnik	/pɔʋéːdnik/
povódni kȍnj	/pɔʋɔ̀ːdni kɔ́n/
klobučár	/klɔbut͡ʃàːr/
rẹ̑d	/réːt/
do	/dÉ”/
vratȉč	/ʋratít͡ʃ/
otáva	/ɔtàːʋa/
slȁb	/sláp/
zgréšiti	/zɡrɛ̀ːʃiti/
vółga	/ʋɔ̀ːʋɡa/
čẹ́maž	/t͡ʃèːmaʃ/
se	/sɛ/
odrešeník	/ɔdrɛʃɛnìːk/
gáms	/ɡàːms/
lẹ́šnik	/lèːʃnik/
vọ̑jvodina	/ʋóːjʋɔdina/
mīrna Bọ̑sna	/mìːrna bóːsna/
dóbro jútro	/dɔ̀ːbrɔ jùːtrɔ/
diják	/dijàːk/
podgána	/pɔdɡàːna/
medeníca	/mɛdɛnìːt͡sa/
kẹ́lih	/kèːlix/
povrȃtnik	/pɔʋráːtnik/
površína	/pɔʋərʃìːna/
pozabīti	/pɔzabìːti/
pozȃvna	/pɔzáːʋna/
pozdrȁv	/pɔzdráʋ/
pózən	/pɔ̀ːzən/
pozitrọ̑n	/pɔzitróːn/
poznáti	/pɔznàːti/
pózno	/pɔ̀ːznɔ/
pozọ́rnost	/pɔzòːrnɔst/
požȃr	/pɔʒáːr/
prȃ-	/práː-/
prȃbábica	/práːbàːbit͡sa/
prȃdẹ̑d	/práːdéːt/
Prága	/pràːɡa/
prȃgermȃnščina	/práːɡɛrmáːnʃt͡ʃina/
prȃh	/práːx/
prȃkrt	/práːkərt/
praporščák	/prapɔrʃt͡ʃàːk/
praporščákinja	/prapɔrʃt͡ʃàːkinja/
práprot	/pràːprɔt/
prasȅ	/prasɛ́/
prȃslovȃnski	/práːslɔʋáːnski/
prȃslovȃnščina	/práːslɔʋáːnʃt͡ʃina/
prášati	/pràːʃati/
prášič	/pràːʃit͡ʃ/
prȃšnik	/práːʃnik/
prȃštevílo	/práːʃtɛʋìːlɔ/
práti	/pràːti/
pravíca	/praʋìːt͡sa/
pravīčən	/praʋìːt͡ʃən/
pravīčnost	/praʋìːt͡ʃnɔst/
pravȋlən	/praʋíːlən/
pravȋlneje	/praʋíːlnɛjɛ/
pravȋlnejše	/praʋíːlnɛjʃɛ/
pravȋlno	/praʋíːlnɔ/
prȁvkar	/práʋkar/
prȃvo	/práːʋɔ/
pravopȋs	/praʋɔpíːs/
prázən	/pràːzən/
prazeodȋm	/prazɛɔdíːm/
praznīti	/praznìːti/
prážiti	/pràːʒiti/
pre-	/prɛ-/
prebȃva	/prɛbáːʋa/
prebíti	/prɛbìːti/
prebivȃləc	/prɛbiʋáːlət͡s/
pred	/prɛt/
pred-	/prɛd-/
predȃl	/prɛdáːl/
predhọ̑dnik	/prɛdxóːdnik/
predlȃgati	/prɛdláːɡati/
prédlog	/prɛ̀ːdlɔk/
prédmet	/prɛ̀ːdmɛt/
prẹ̑dnik	/préːdnik/
predpọ̑na	/prɛtpóːna/
prȅdpretéklik	/prɛ́tprɛtɛ̀ːklik/
predsẹ̑dnik	/prɛtséːdnik/
predvídeti	/prɛdʋìːdɛti/
predvidljīv	/prɛdʋidljìːʋ/
predvidljívost	/prɛdʋidljìːʋɔst/
prehlȁd	/prɛxlát/
prēja	/prɛ̀ːja/
preklẹ̑tstvo	/prɛkléːtstʋɔ/
premẹ̑na	/prɛméːna/
premenīti	/prɛmɛnìːti/
preobràt	/prɛɔbràt/
prepelíca	/prɛpɛlìːt͡sa/
preprọ̄ga	/prɛpròːɡa/
prepúcij	/prɛpùːt͡sij/
prepȗstnica	/prɛpúːstnit͡sa/
presenẹ̑čenje	/prɛsɛnéːt͡ʃɛnjɛ/
presenẹ̄titi	/prɛsɛnèːtiti/
presrẹ̑dək	/prɛsréːdək/
présti	/prɛ̀ːsti/
préstol	/prɛ̀ːstɔl/
prestọ̑lnica	/prɛstóːlnit͡sa/
prestọ̑pno lẹ́to	/prɛstóːpnɔ lèːtɔ/
pretéklik	/prɛtɛ̀ːklik/
prevajȃləc	/prɛʋajáːlət͡s/
prevésti	/prɛʋɛ̀ːsti/
prevȍd	/prɛʋɔ́t/
prevọ̑dnik	/prɛʋóːdnik/
preživẹ́ti	/prɛʒiʋèːti/
pŕga	/pə̀rɡa/
pŕha	/pə̀rxa/
pri	/pri/
pri-	/pri-/
príča	/prìːt͡ʃa/
pričakováti	/prit͡ʃakɔʋàːti/
prídən	/prìːdən/
pridẹ̑vnik	/pridéːʋnik/
pridẹ̑vniški	/pridéːʋniʃki/
prídnejši	/prìːdnɛjʃi/
prihȃjati	/prixáːjati/
prihọ̑dnji	/prixóːdnji/
prihọ̑dnjik	/prixóːdnjik/
prihọ̑dnost	/prixóːdnɔst/
priȋmək	/priíːmək/
prijȃtelj	/prijáːtɛl/
prijȃteljica	/prijáːtɛljit͡sa/
prijȃteljski	/prijáːtɛlski/
prijȃteljstvo	/prijáːtɛlstʋɔ/
prijáviti	/prijàːʋiti/
prijázən	/prijàːzən/
prijáznejši	/prijàːznɛjʃi/
prijẹ́tən	/prijèːtən/
prilọ́žnost	/prilòːʒnɔst/
primẹ̑r	/priméːr/
prīmež	/prìːmɛʃ/
prȋnc	/príːnt͡s/
princẹ̑sa	/print͡séːsa/
pripẹ́ti	/pripèːti/
pripọ̑na	/pripóːna/
pripọ̑nski	/pripóːnski/
prisẹ̑ga	/priséːɡa/
prislȍv	/prislɔ́ʋ/
prisótnost	/prisɔ̀ːtnɔst/
prispẹ̑vək	/prispéːʋək/
pristáti	/pristàːti/
príti	/prìːti/
pritȋsk	/pritíːsk/
priznáti	/priznàːti/
priznȃvati	/priznáːʋati/
prīžnica	/prìːʒnit͡sa/
pro-	/prɔ-/
profẹ̑sor	/prɔféːsɔr/
progrȃmje	/prɔɡráːmjɛ/
progrȃmska oprẹ̑ma	/prɔɡráːmska ɔpréːma/
progrȃmski	/prɔɡráːmski/
promẹ́tij	/prɔmèːtij/
prọ́sim	/pròːsim/
prosīti	/prɔsìːti/
prȍst	/prɔ́st/
prọ̑stata	/próːstata/
prostitúcija	/prɔstitùːt͡sija/
próstor	/prɔ̀ːstɔr/
próstor-čȁs	/prɔ̀ːstɔr t͡ʃás/
prostornína	/prɔstɔrnìːna/
prostọ̄rski	/prɔstòːrski/
protaktínij	/prɔtaktìːnij/
prọ̑tipomẹ̑nka	/próːtipɔméːnka/
pȓst	/pə́rst/
pŕstan	/pə̀rstan/
pŕstanəc	/pə̀rstanət͡s/
pȓt	/pə́rt/
prtljȃga	/pərtljáːɡa/
prvák	/pərʋàːk/
pȓvi	/pə́rʋi/
prvótən	/pərʋɔ̀ːtən/
Psȃlmi	/psáːlmi/
psíca	/psìːt͡sa/
pšeníca	/pʃɛnìːt͡sa/
ptíca	/ptìːt͡sa/
ptȉč	/ptít͡ʃ/
ptȋčje strašílo	/ptíːt͡ʃjɛ straʃìːlɔ/
pūhati	/pùːxati/
pȗlzar	/púːlzar/
púma	/pùːma/
pȕnt	/púnt/
purȃn	/puráːn/
pȗst	/púːst/
pustȇjši	/pustɛ́ːjʃi/
pustínja	/pustìːnja/
pustīti	/pustìːti/
púščati	/pùːʃt͡ʃati/
puščȃva	/puʃt͡ʃáːʋa/
pȗška	/púːʃka/
rába	/ràːba/
rabárbara	/rabàːrbara/
rabīti	/rabìːti/
ráca	/ràːt͡sa/
računȃlnik	/rat͡ʃunáːlnik/
rȁd	/rát/
rādar	/ràːdar/
rādij	/ràːdij/
radȋrka	/radíːrka/
radọ̑n	/ráːdɔn/
rádost	/ràːdɔst/
radovẹ́dən	/radɔʋèːdən/
radovẹ́dnost	/radɔʋèːdnɔst/
rakȗn	/rakúːn/
rálo	/ràːlɔ/
ráma	/ràːma/
Ramȏvš	/ramɔ́ːʋʃ/
rȃn	/ráːn/
rána	/ràːna/
ránejši	/ràːnɛjʃi/
rása	/ràːsa/
rȃst	/ráːst/
rásti	/ràːsti/
rastlína	/rastlìːna/
rastlinojẹ̑dəc	/rastlinɔjéːdət͡s/
rávən	/ràːʋən/
rávnejši	/ràːʋnɛjʃi/
Rȃvnik	/ráːʋnik/
rávnost	/ràːʋnɔst/
ravnotẹ̑žje	/raʋnɔtéːʒjɛ/
raz-	/raz-/
razglẹ̑dnica	/razɡléːdnit͡sa/
klobučár	/klɔbut͡ʃàːr/
rẹ̑d	/réːt/
do	/dÉ”/
vratȉč	/ʋratít͡ʃ/
otáva	/ɔtàːʋa/
slȁb	/sláp/
zgréšiti	/zɡrɛ̀ːʃiti/
vółga	/ʋɔ̀ːʋɡa/
čẹ́maž	/t͡ʃèːmaʃ/
se	/sɛ/
odrešeník	/ɔdrɛʃɛnìːk/
gáms	/ɡàːms/
lẹ́šnik	/lèːʃnik/
vọ̑jvodina	/ʋóːjʋɔdina/
mīrna Bọ̑sna	/mìːrna bóːsna/
dóbro jútro	/dɔ̀ːbrɔ jùːtrɔ/
diják	/dijàːk/
podgána	/pɔdɡàːna/
medeníca	/mɛdɛnìːt͡sa/
kẹ́lih	/kèːlix/
razgȏvor	/razɡɔ́ːʋɔr/
razlíčən	/razlìːt͡ʃən/
razlíčnejši	/razlìːt͡ʃnɛjʃi/
razlȋka	/razlíːka/
razpélo	/raspɛ̀ːlɔ/
rázred	/ràːzrɛt/
razumẹ́ti	/razumèːti/
razvȍj	/razʋɔ́j/
rdȅč	/ərdɛ́t͡ʃ/
rdẹ́ča velikȃnka	/ərdèːt͡ʃa ʋɛlikáːnka/
Rdẹ́če mọ̑rje	/ərdèːt͡ʃɛ móːrjɛ/
rdẹ́če víno	/ərdèːt͡ʃɛ ʋìːnɔ/
rébro	/rɛ̀ːbrɔ/
reciklȋranje	/rɛt͡siklíːranjɛ/
rẹ̑č	/réːt͡ʃ/
réči	/rɛ̀ːt͡ʃi/
rẹ̑d	/réːt/
redár	/rɛdàːr/
rẹ́dək	/rèːdək/
redkȇjši	/rɛtkɛ́ːjʃi/
rédkəv	/rɛ̀ːtkəʋ/
rẹ́dko	/rèːtkɔ/
rẹ́grat	/rèːɡrat/
rẹ̑k	/réːk/
rẹ́ka	/rèːka/
rektȃlən	/rɛktáːlən/
rẹ̑lativnost	/réːlatiʋnɔst/
relígija	/rɛlìːɡija/
relíkvija	/rɛlìːkʋija/
renesȃnsa	/rɛnɛsáːnsa/
rẹ́nij	/rèːnij/
rȅp	/rɛ́p/
repatíca	/rɛpatìːt͡sa/
repúblika	/rɛpùːblika/
resníca	/rɛsnìːt͡sa/
resnīčən	/rɛsnìːt͡ʃən/
resnīčnejši	/rɛsnìːt͡ʃnɛjʃi/
Rẹ̑snik	/réːsnik/
restavrácija	/rɛstaʋràːt͡sija/
rešéto	/rɛʃɛ̀ːtɔ/
rẹ́ši	/rèːʃi/
rešȋtəv	/rɛʃíːtəʋ/
rešīti	/rɛʃìːti/
rẹ́vən	/rèːʋən/
revȋja	/rɛʋíːja/
rẹ́vnejši	/rèːʋnɛjʃi/
revolúcija	/rɛʋɔlùːt͡sija/
rẹ́zati	/rèːzati/
rezílo	/rɛzìːlɔ/
rezultȃt	/rɛzultáːt/
ríba	/rìːba/
ribáriti	/ribàːriti/
Ríbi	/rìːbi/
Rígler	/rìːɡlɛr/
Ríjavəc	/rìːjaʋət͡s/
rȋləc	/ríːlət͡s/
Rím	/rìːm/
rīma	/rìːma/
rȋs	/ríːs/
rȋsati	/ríːsati/
rȋsba	/ríːzba/
rȉt	/rít/
ríti	/rìːti/
rȋž	/ríːʃ/
rjȁv	/ərjáʋ/
rjúha	/ərjùːxa/
rjúti	/ərjùːti/
rọ̑b	/róːp/
robȋdnica	/rɔbíːdnit͡sa/
robọ̑t	/rɔbóːt/
rọ́dij	/ròːdij/
rodȋlnik	/rɔdíːlnik/
rodīti	/rɔdìːti/
rọ̑g	/róːk/
rójen	/rɔ̀ːjɛn/
rójstvo	/rɔ̀ːjstʋɔ/
róka	/rɔ̀ːka/
rokavíca	/rɔkaʋìːt͡sa/
rokomȅt	/rɔkɔmɛ́t/
romȃn	/rɔmáːn/
rọ̑mb	/róːmp/
Romȗn	/rɔmúːn/
Romúnija	/rɔmùːnija/
Romȗnka	/rɔmúːnka/
romȗnski	/rɔmúːnski/
romȗnsko	/rɔmúːnskɔ/
romȗnščina	/rɔmúːnʃt͡ʃina/
rọ̑par	/róːpar/
rósa	/rɔ̀ːsa/
rosomȃh	/rɔsɔmáːx/
rọ̑tovž	/róːtɔʋʃ/
rȏvka	/rɔ́ːʋka/
Rọ̑zman	/róːzman/
rọ̑ža	/róːʒa/
roževína	/rɔʒɛʋìːna/
rọ̑žmarin	/róːʒmarin/
rọ̑žni vénəc	/róːʒni ʋɛ̀ːnət͡s/
rubídij	/rubìːdij/
rúda	/rùːda/
rudár	/rudàːr/
rȗdnik	/rúːdnik/
rumȅn	/rumɛ́n/
rumenják	/rumɛnjàːk/
rūno	/rùːnɔ/
Rȗs	/rúːs/
Rȗsija	/rúːsija/
Rȗsinja	/rúːsinja/
rȗski	/rúːski/
rȗsko	/rúːskɔ/
rȗščina	/rúːʃt͡ʃina/
rutẹ́nij	/rutèːnij/
rúti	/rùːti/
ruváti	/ruʋàːti/
rváti	/ərʋàːti/
ȓž	/ə́rʃ/
s	/s/
sȃblja	/sáːblja/
sabotȃža	/sabɔtáːʒa/
sȃd	/sáːt/
sȃdež	/sáːdɛʃ/
sádje	/sàːdjɛ/
sadovnják	/sadɔʋnjàːk/
saksofọ̑n	/saksɔfóːn/
sȃm	/sáːm/
samárij	/samàːrij/
sáməc	/sàːmət͡s/
sȃmo-	/sáːmɔ-/
samoglȃsnik	/samɔɡláːsnik/
samọ̑množȋnski	/samóːmnɔʒíːnski/
samomȍr	/samɔmɔ́r/
samorọ̑g	/samɔróːk/
samostȃlnik	/samɔstáːlnik/
samostȃlniški	/samɔstáːlniʃki/
samostȃn	/samɔstáːn/
samóta	/samɔ̀ːta/
sȃmozadovoljevánje	/sáːmɔzadɔʋɔljɛʋàːnjɛ/
sȃmozadovoljeváti	/sáːmɔzadɔʋɔljɛʋàːti/
samȗm	/samúːm/
sánjati	/sàːnjati/
sánje	/sàːnjɛ/
sanskȓt	/sanskə́rt/
sȃpnik	/sáːpnik/
Sardínija	/sardìːnija/
satelȋt	/satɛlíːt/
Satúrn	/satùːrn/
scenárij	/st͡sɛnàːrij/
se	/sɛ/
sẹ̑č	/séːt͡ʃ/
sẹ́či	/sèːt͡ʃi/
sẹ̑čnica	/séːt͡ʃnit͡sa/
sẹ̑čničən	/séːt͡ʃnit͡ʃən/
sedānjik	/sɛdàːnjik/
sẹ́dəm	/sèːdəm/
sẹ́dəmdeset	/sèːdəmdɛsɛt/
sedəmnájst	/sɛdəmnàːjst/
sedẹ́ti	/sɛdèːti/
sédlo	/sɛ̀ːdlɔ/
sẹ̑f	/séːf/
sejáti	/sɛjàːti/
Sejšẹ̑li	/sɛjʃéːli/
sekȃləc	/sɛkáːlət͡s/
sekíra	/sɛkìːra/
sẹ̑ks	/séːks/
sẹ̑ksati	/séːksati/
seksologíja	/sɛksɔlɔɡìːja/
seksuȃlən	/sɛksuáːlən/
seksuȃlnost	/sɛksuáːlnɔst/
sekȗnda	/sɛkúːnda/
sə̏l	/sə́l/
selẹ̑n	/sɛléːn/
sem	/sə́m/
sẹ́me	/sèːmɛ/
semenovȍd	/sɛmɛnɔʋɔ́t/
semẹ̑nski	/sɛméːnski/
sẹ̑nca	/séːnt͡sa/
sẹ̑ndvič	/séːndʋit͡ʃ/
senọ̑	/sɛnóː/
senóžet	/sɛnɔ̀ːʒɛt/
septémbər	/sɛptɛ̀ːmbər/
səsȃləc	/səsáːlət͡s/
səsáti	/səsàːti/
sẹ́sti	/sèːsti/
séstra	/sɛ̀ːstra/
sestrȋčna	/sɛstríːt͡ʃna/
sevẹ̑da	/sɛʋéːda/
sẹ́ver	/sèːʋɛr/
sẹ́verən	/sèːʋɛrən/
sẹ́vernejši	/sèːʋɛrnɛjʃi/
sẹ́verni jélen	/sèːʋɛrni jɛ̀ːlɛn/
sẹ́verni médved	/sèːʋɛrni mɛ̀ːdʋɛt/
səznȁm	/səznám/
səzúti	/səzùːti/
shizofrenȋja	/sxizɔfrɛníːja/
Sibírija	/sibìːrija/
Sicílija	/sit͡sìːlija/
sīdro	/sìːdrɔ/
síla	/sìːla/
silícij	/silìːt͡sij/
simbọ̑l	/simbóːl/
simbọ́ličən	/simbòːlit͡ʃən/
klobučár	/klɔbut͡ʃàːr/
rẹ̑d	/réːt/
do	/dÉ”/
vratȉč	/ʋratít͡ʃ/
otáva	/ɔtàːʋa/
slȁb	/sláp/
zgréšiti	/zɡrɛ̀ːʃiti/
vółga	/ʋɔ̀ːʋɡa/
čẹ́maž	/t͡ʃèːmaʃ/
se	/sɛ/
odrešeník	/ɔdrɛʃɛnìːk/
gáms	/ɡàːms/
lẹ́šnik	/lèːʃnik/
vọ̑jvodina	/ʋóːjʋɔdina/
mīrna Bọ̑sna	/mìːrna bóːsna/
dóbro jútro	/dɔ̀ːbrɔ jùːtrɔ/
diják	/dijàːk/
podgána	/pɔdɡàːna/
medeníca	/mɛdɛnìːt͡sa/
kẹ́lih	/kèːlix/
simetrȋja	/simɛtríːja/
sȋn	/síːn/
sinhrọ̑n	/sinxróːn/
sinhrọ̑no	/sinxróːnɔ/
siníca	/sinìːt͡sa/
sinọ̑či	/sinóːt͡ʃi/
sinonȋm	/sinɔníːm/
sȉr	/sír/
Sírija	/sìːrija/
sirílo	/sirìːlɔ/
sirȋščnik	/siríːʃt͡ʃnik/
síriti	/sìːriti/
sírotka	/sìːrɔtka/
sistẹ̑m	/sistéːm/
sistẹ̑mska vrstíca	/sistéːmska ʋərstìːt͡sa/
sȉt	/sít/
sȋv	/síːʋ/
skakáč	/skakàːt͡ʃ/
skála	/skàːla/
skándij	/skàːndij/
-ski	/-ski/
skládnja	/sklàːdnja/
sklanjȃtəv	/sklanjáːtəʋ/
sklẹ́da	/sklèːda/
sklȍn	/sklɔ́n/
skočīti	/skɔt͡ʃìːti/
skodẹ̑lica	/skɔdéːlit͡sa/
skōraj	/skɔ̀ːraj/
skorbȗt	/skɔrbúːt/
skọ̄rja	/skòːrja/
skríti	/skrìːti/
skrívati	/skrìːʋati/
skrȋvən	/skríːʋən/
skrȋvnejši	/skríːʋnɛjʃi/
skrivnọ̑st	/skriʋnóːst/
skrivnọ̑stən	/skriʋnóːstən/
skrivnọ̑stnejši	/skriʋnóːstnɛjʃi/
skrómən	/skrɔ̀ːmən/
skrómnejši	/skrɔ̀ːmnɛjʃi/
skrọ̑tum	/skróːtum/
skȗpaj	/skúːpaj/
skupína	/skupìːna/
skūpnost	/skùːpnɔst/
skúsiti	/skùːsiti/
skúša	/skùːʃa/
slȁb	/sláp/
slabọ̑	/slabóː/
slȃbše	/sláːpʃɛ/
slȃbši	/sláːpʃi/
slȃd	/sláːt/
sladȇjši	/sladɛ́ːjʃi/
sládək	/slàːdək/
sládkor	/slàːtkɔr/
sladolẹ̑d	/sladɔléːt/
slȃjši	/sláːjʃi/
slámica	/slàːmit͡sa/
slȃn	/sláːn/
slanína	/slanìːna/
slȃp	/sláːp/
slaščičȃrna	/slaʃt͡ʃit͡ʃáːrna/
sláva	/slàːʋa/
slávəc	/slàːʋət͡s/
slávən	/slàːʋən/
slẹ́či	/slèːt͡ʃi/
sledīti	/slɛdìːti/
slẹ̑p	/sléːp/
slezẹ̑novəc	/slɛzéːnɔʋət͡s/
slȋka	/slíːka/
slikár	/slikàːr/
slȋkati	/slíːkati/
slína	/slìːna/
slíšati	/slìːʃati/
slíva	/slìːʋa/
slívovka	/slìːʋɔʋka/
sljúda	/sljùːda/
slọ̄ka	/slòːka/
slȍn	/slɔ́n/
sloníca	/slɔnìːt͡sa/
Slonokoščẹ̑na obȃla	/slɔnɔkɔʃt͡ʃéːna ɔbáːla/
slonovína	/slɔnɔʋìːna/
slȍp	/slɔ́p/
Slovák	/slɔʋàːk/
Slovákinja	/slɔʋàːkinja/
Slovȃn	/slɔʋáːn/
Slovȃnka	/slɔʋáːnka/
slovȃnski	/slɔʋáːnski/
slovár	/slɔʋàːr/
slovȃščina	/slɔʋáːʃt͡ʃina/
Slovȃška	/slɔʋáːʃka/
slovȃški	/slɔʋáːʃki/
slovȃško	/slɔʋáːʃkɔ/
Slovẹ́nəc	/slɔʋèːnət͡s/
Slovẹ́nija	/slɔʋèːnija/
Slovẹ́nka	/slɔʋèːnka/
slovẹ́nski	/slɔʋèːnski/
slovẹ́nsko	/slɔʋèːnskɔ/
slovẹ́nščina	/slɔʋèːnʃt͡ʃina/
slovẹ́ti	/slɔʋèːti/
slȏvnica	/slɔ́ːʋnit͡sa/
slȏvničən	/slɔ́ːʋnit͡ʃən/
slovọ̑	/slɔʋóː/
slúšati	/slùːʃati/
slúti	/slùːti/
slȗžba	/slúːʒba/
smẹ̑h	/sméːx/
smejáti	/smɛjàːti/
smẹ̑ł	/sméːʋ/
smẹ́lejši	/smèːlɛjʃi/
smẹ̑r	/sméːr/
smẹ̑t	/sméːt/
smẹ́tana	/smèːtana/
smẹ́ti	/smèːti/
smȋsəł	/smíːsəʋ/
smȍ	/smɔ́/
smodník	/smɔdnìːk/
smóla	/smɔ̀ːla/
smrẹ́ka	/smrèːka/
smȓt	/smə́rt/
smȓtna kȃzən	/smə́rtna káːzən/
smrtonósən	/smərtɔnɔ̀ːsən/
smȗčati	/smúːt͡ʃati/
snáha	/snàːxa/
snẹ̑g	/snéːk/
Snegȗljčica	/snɛɡúːlt͡ʃit͡sa/
snẹ́ti	/snèːti/
snežák	/snɛʒàːk/
snežȋnka	/snɛʒíːnka/
snežīti	/snɛʒìːti/
snováti	/snɔʋàːti/
snúti	/snùːti/
sȍ	/sɔ́/
sóba	/sɔ̀ːba/
sobána	/sɔbàːna/
sobọ́ta	/sɔbòːta/
Socialístična federatȋvna repȗblika Jugoslávija	/sɔt͡sialìːstit͡ʃna fɛdɛratíːʋna rɛpúːblika juɡɔslàːʋija/
socialízəm	/sɔt͡sijalìːzəm/
socvẹ̑tje	/sɔt͡sʋéːtjɛ/
Sọ́ča	/sòːt͡ʃa/
sọ̑d	/sóːt/
sodník	/sɔdnìːk/
sodóbən	/sɔdɔ̀ːbən/
sodóbnejši	/sɔdɔ̀ːbnɛjʃi/
sọ̑k	/sóːk/
sókol	/sɔ̀ːkɔl/
Sọ̑krat	/sóːkrat/
sọ̑ł	/sóːʋ/
solȃrən	/sɔláːrən/
sółza	/sɔ̀ːʋza/
sonatȋna	/sɔnatíːna/
sọ̑nce	/sóːnt͡sɛ/
sọ̑nčən	/sóːnt͡ʃən/
sọ̑nčev vẹ̑tər	/sóːnt͡ʃɛʋ ʋéːtər/
sọ̑nčna ȗra	/sóːnt͡ʃna úːra/
sọ̑nčnejši	/sóːnt͡ʃnɛjʃi/
sọ̑nčnica	/sóːnt͡ʃnit͡sa/
sọ̑nčnik	/sóːnt͡ʃnik/
sonẹ̑t	/sɔnéːt/
sȍpomẹ̑nka	/sɔ́pɔméːnka/
soprọ̑g	/sɔpróːk/
sȍrojénəc	/sɔ́rɔjɛ̀ːnət͡s/
sósed	/sɔ̀ːsɛt/
sóva	/sɔ̀ːʋa/
sovrȃštvo	/sɔʋráːʃtʋɔ/
sovražīti	/sɔʋraʒìːti/
sovrȃžnik	/sɔʋráːʒnik/
spȃlnica	/spáːlnit͡sa/
spȃm	/spɛ́ːm/
spáti	/spàːti/
spȇm	/spɛ́ːm/
spȇrma	/spɛ́ːrma/
spẹ̑t	/spéːt/
spẹ́ti	/spèːti/
splóšən	/splɔ̀ːʃən/
splóšnejši	/splɔ̀ːʃnɛjʃi/
spódaj	/spɔ̀ːdaj/
spodọ́bən	/spɔdòːbən/
spodọ́bnejši	/spɔdòːbnɛjʃi/
spogledováti	/spɔɡlɛdɔʋàːti/
spojína	/spɔjìːna/
spȍl	/spɔ́l/
spȏlna orientácija	/spɔ́ːlna ɔriɛntàːt͡sija/
spȏlna usmẹ̑rjenost	/spɔ́ːlna usméːrjɛnɔst/
spolovílo	/spɔlɔʋìːlɔ/
spomȋn	/spɔmíːn/
spomȋnčica	/spɔmíːnt͡ʃit͡sa/
spomínjati	/spɔmìːnjati/
spọ̑mniti	/spóːmniti/
sporočílo	/spɔrɔt͡ʃìːlɔ/
sposodīti	/spɔsɔdìːti/
spoznáti	/spɔznàːti/
spregȃtəv	/sprɛɡáːtəʋ/
spremẹ̑mba	/sprɛméːmba/
spremenīti	/sprɛmɛnìːti/
sprẹ́tnost	/sprèːtnɔst/
sprevọ̑dnik	/sprɛʋóːdnik/
spustīti	/spustìːti/
srájca	/sràːjt͡sa/
sráka	/sràːka/
srānje	/sràːnjɛ/
sráti	/sràːti/
klobučár	/klɔbut͡ʃàːr/
rẹ̑d	/réːt/
do	/dÉ”/
vratȉč	/ʋratít͡ʃ/
otáva	/ɔtàːʋa/
slȁb	/sláp/
zgréšiti	/zɡrɛ̀ːʃiti/
vółga	/ʋɔ̀ːʋɡa/
čẹ́maž	/t͡ʃèːmaʃ/
se	/sɛ/
odrešeník	/ɔdrɛʃɛnìːk/
gáms	/ɡàːms/
lẹ́šnik	/lèːʃnik/
vọ̑jvodina	/ʋóːjʋɔdina/
mīrna Bọ̑sna	/mìːrna bóːsna/
dóbro jútro	/dɔ̀ːbrɔ jùːtrɔ/
diják	/dijàːk/
podgána	/pɔdɡàːna/
medeníca	/mɛdɛnìːt͡sa/
kẹ́lih	/kèːlix/
Sȓb	/sə́rp/
Sȓbija	/sə́rbija/
Sȓbkinja	/sə́rpkinja/
srbohrvȃščina	/sərbɔxərʋáːʃt͡ʃina/
srbohrvȃški	/sərbɔxərʋáːʃki/
sȓbski	/sə́rpski/
sȓbščina	/sə́rpʃt͡ʃina/
srcẹ̑	/sərt͡séː/
srebȓn	/srɛbə́rn/
srebrnína	/srɛbərnìːna/
srebrọ̑	/srɛbróː/
srẹ́ča	/srèːt͡ʃa/
srẹ̑čati	/sréːt͡ʃati/
srẹ́čən	/srèːt͡ʃən/
srẹ́čneje	/srèːt͡ʃnɛjɛ/
srẹ́čnejše	/srèːt͡ʃnɛjʃɛ/
srẹ́čnejši	/srèːt͡ʃnɛjʃi/
srẹ́čno	/srèːt͡ʃnɔ/
srẹ̑da	/sréːda/
sredȋnəc	/srɛdíːnət͡s/
sredíšče	/srɛdìːʃt͡ʃɛ/
Srẹ̑dnja Evrọ̑pa	/sréːdnja ɛʋróːpa/
srednjevalȏvən	/srɛdnjɛʋalɔ́ːʋən/
srednjevẹ̑ški	/srɛdnjɛʋéːʃki/
srẹ̑dnji	/sréːdnji/
sŕna	/sə̀rna/
sȓp	/sə́rp/
sršȅn	/sərʃɛ́n/
stȁ	/stá/
stánje	/stàːnjɛ/
stanováti	/stanɔʋàːti/
stȁr	/stár/
stȃrəc	/stáːrət͡s/
starȇjši	/starɛ́ːjʃi/
stȃri óče	/stáːri ɔ̀ːt͡ʃɛ/
stȃrka	/stáːrka/
starodávən	/starɔdàːʋən/
stárost	/stàːrɔst/
státi	/stàːti/
stȃvba	/stáːʋba/
stȃvək	/stáːʋək/
stáviti	/stàːʋiti/
stȅ	/stɛ́/
stégno	/stɛ̀ːɡnɔ/
stekleníca	/stɛklɛnìːt͡sa/
	
stẹ́na	/stèːna/
stetoskọ̑p	/stɛtɔskóːp/
stəzȁ	/stəzá/
stikálo	/stikàːlɔ/
stọ̑	/stóː/
stȍł	/stɔ́ʋ/
stolẹ̑tje	/stɔléːtjɛ/
stȍlp	/stɔ́lp/
stopálo	/stɔpàːlɔ/
stopīti	/stɔpìːti/
stopníšče	/stɔpnìːʃt͡ʃɛ/
stọ̑tnica	/stóːtnit͡sa/
stọ̑tnik	/stóːtnik/
stóžəc	/stɔ̀ːʒət͡s/
strȃh	/stráːx/
strȃn	/stráːn/
straníšče	/stranìːʃt͡ʃɛ/
strȃnka	/stráːnka/
strȃst	/stráːst/
strástən	/stràːstən/
strástnejši	/stràːstnɛjʃi/
strategȋja	/stratɛɡíːja/
strẹ́či	/strèːt͡ʃi/
strẹ́ha	/strèːxa/
strẹ́la	/strèːla/
strẹ́šica	/strèːʃit͡sa/
stŕgati	/stə̀rɡati/
stríc	/strìːt͡s/
stríči	/strìːt͡ʃi/
strọ̑g	/stróːk/
strȍj	/strɔ́j/
strȏjən	/strɔ́ːjən/
strojīti	/strɔjìːti/
strọ́ncij	/stròːnt͡sij/
strȍp	/strɔ́p/
struktȗra	/struktúːra/
strukturȃlən	/strukturáːlən/
strȗp	/strúːp/
strȗpən	/strúːpən/
stvȃr	/stʋáːr/
Sȗeški prekȍp	/súːɛʃki prɛkɔ́p/
sȗh	/súːx/
sȗm	/súːm/
suspenzọ́rij	/suspɛnzòːrij/
súša	/sùːʃa/
súti	/sùːti/
súžənj	/sùːʒən/
súžənjstvo	/sùːʒənstʋɔ/
svȁ	/sʋá/
svák	/sʋàːk/
svākinja	/sʋàːkinja/
svẹ́ča	/sʋèːt͡ʃa/
svẹ̑t	/sʋéːt/
svétəł	/sʋɛ̀ːtəʋ/
svetȋlnik	/sʋɛtíːlnik/
svetlóba	/sʋɛtlɔ̀ːba/
svetlóbno lẹ́to	/sʋɛtlɔ̀ːbnɔ lèːtɔ/
svẹ̑tnik	/sʋéːtnik/
svȋla	/sʋíːla/
sviloprȇjka	/sʋilɔprɛ́ːjka/
svínčnik	/sʋìːnt͡ʃnik/
svínəc	/sʋìːnət͡s/
svȋzəc	/sʋíːzət͡s/
svobóda	/sʋɔbɔ̀ːda/
svobódən	/sʋɔbɔ̀ːdən/
svobódnejši	/sʋɔbɔ̀ːdnɛjʃi/
svọ́j	/sʋòːj/
svojína	/sʋɔjìːna/
Sy̑dney	/síːdni/
šȃh	/ʃáːx/
šahȏvnica	/ʃaxɔ́ːʋnit͡sa/
šakȃl	/ʃakáːl/
šȃl	/ʃáːl/
šȃnk	/ʃáːnk/
šantáti	/ʃantàːti/
šȃrenica	/ʃáːrɛnit͡sa/
ščegetȃvčək	/ʃt͡ʃɛɡɛtáːʋt͡ʃək/
ščẹ̑t	/ʃt͡ʃéːt/
ščínkavəc	/ʃt͡ʃìːnkaʋət͡s/
ščȋr	/ʃt͡ʃíːr/
ščȋt	/ʃt͡ʃíːt/
ščúka	/ʃt͡ʃùːka/
ščúrək	/ʃt͡ʃùːrək/
šȅ	/ʃɛ́/
šẹ̑st	/ʃéːst/
šẹ̑stdeset	/ʃéːzddɛsɛt/
šésti	/ʃɛ̀ːsti/
šestnájst	/ʃɛstnàːjst/
šíbka interákcija	/ʃìːpka intɛràːkt͡sija/
šíbka jēdrska síla	/ʃìːpka jɛ̀ːdərska sìːla/
šȋlčək	/ʃíːlt͡ʃək/
šíliti	/ʃìːliti/
šimpȃnz	/ʃimpáːns/
širȍk	/ʃirɔ́k/
šíti	/ʃìːti/
škȃrje	/ʃkáːrjɛ/
škȃtla	/ʃkáːtla/
škȍf	/ʃkɔ́f/
škórəc	/ʃkɔ̀ːrət͡s/
škọ̑rənj	/ʃkóːrən/
škorpijọ̑n	/ʃkɔrpijóːn/
Škọ̑tska	/ʃkóːtska/
škrīpəc	/ʃkrìːpət͡s/
škrjánəc	/ʃkərjàːnət͡s/
Škrjánəc	/ʃkərjàːnət͡s/
škržȃt	/ʃkərʒáːt/
šọ́ja	/ʃòːja/
šọ̑la	/ʃóːla/
Špȃnəc	/ʃpáːnət͡s/
Špánija	/ʃpàːnija/
Špȃnka	/ʃpáːnka/
špȃnski	/ʃpáːnski/
špȃnsko	/ʃpáːnskɔ/
špȃnščina	/ʃpáːnʃt͡ʃina/
špȋrit	/ʃpíːrit/
štacún	/ʃtat͡sùːn/
štẹ́ti	/ʃtèːti/
števílo	/ʃtɛʋìːlɔ/
štẹ̑vnik	/ʃtéːʋnik/
štíri	/ʃtìːri/
štȋrideset	/ʃtíːridɛsɛt/
štirinájst	/ʃtirinàːjst/
štírje	/ʃtìːrjɛ/
štọ̑r	/ʃtóːr/
štọ̑rklja	/ʃtóːrklja/
študȅnt	/ʃtudɛ́nt/
študȋrati	/ʃtudíːrati/
šȗm	/ʃúːm/
šȗnka	/ʃúːnka/
Švẹ̑d	/ʃʋéːt/
Švẹ̑dinja	/ʃʋéːdinja/
Švẹ̑dska	/ʃʋéːtska/
švẹ̑dski	/ʃʋéːtski/
švẹ̑dsko	/ʃʋéːtskɔ/
švẹ̑dščina	/ʃʋéːtʃt͡ʃina/
Švȋca	/ʃʋíːt͡sa/
švȋcarski	/ʃʋíːt͡sarski/
tȃ	/táː/
Tadžȋkistan	/tad͡ʒíːkistan/
Tȃjska	/táːjska/
Tȃjvan	/táːjʋan/
takọ̑	/takóː/
takọ̑j	/takóːj/
takrȁt	/takrát/
tálij	/tàːlij/
tȁm	/tám/
tánək	/tàːnək/
tȃntal	/táːntal/
Tanzánija	/tanzàːnija/
tȃrča	/táːrt͡ʃa/
tȃst	/táːst/
tášča	/tàːʃt͡ʃa/
táščica	/tàːʃt͡ʃit͡sa/
tȁt	/tát/
klobučár	/klɔbut͡ʃàːr/
rẹ̑d	/réːt/
do	/dÉ”/
vratȉč	/ʋratít͡ʃ/
otáva	/ɔtàːʋa/
slȁb	/sláp/
zgréšiti	/zɡrɛ̀ːʃiti/
vółga	/ʋɔ̀ːʋɡa/
čẹ́maž	/t͡ʃèːmaʃ/
se	/sɛ/
odrešeník	/ɔdrɛʃɛnìːk/
gáms	/ɡàːms/
lẹ́šnik	/lèːʃnik/
vọ̑jvodina	/ʋóːjʋɔdina/
mīrna Bọ̑sna	/mìːrna bóːsna/
dóbro jútro	/dɔ̀ːbrɔ jùːtrɔ/
diják	/dijàːk/
podgána	/pɔdɡàːna/
medeníca	/mɛdɛnìːt͡sa/
kẹ́lih	/kèːlix/
tȃvžent	/táːʋʒɛnt/
tečȃj	/tɛt͡ʃáːj/
téči	/tɛ̀ːt͡ʃi/
tẹ̑dən	/téːdən/
tehnẹ́cij	/tɛxnèːt͡sij/
tẹ̑k	/téːk/
tekáč	/tɛkàːt͡ʃ/
tekọ̄č	/tɛkòːt͡ʃ/
tekọ́če stopníce	/tɛkòːt͡ʃɛ stɔpnìːt͡sɛ/
tekočína	/tɛkɔt͡ʃìːna/
Tẹ̑ksas	/téːksas/
téle	/tɛ̀ːlɛ/
telẹ̑sən	/tɛléːsən/
telọ̑	/tɛlóː/
telováditi	/tɛlɔʋàːditi/
telūr	/tɛlùːr/
təmȁ	/təmá/
tə̀mən	/tə̀mən/
təmnīti	/təmnìːti/
témpəlj	/tɛ̀ːmpəl/
temperatȗra	/tɛmpɛratúːra/
Tẹ̑mza	/téːmza/
tẹ̑nis	/téːnis/
teorẹ́tičən	/tɛɔrèːtit͡ʃən/
teorȋja	/tɛɔríːja/
teorȋja zarọ̑te	/tɛɔríːja zaróːtɛ/
tépsti	/tɛ̀ːpsti/
terárij	/tɛràːrij/
térbij	/tɛ̀ːrbij/
termȋt	/tɛrmíːt/
terorȋst	/tɛrɔríːst/
tésən	/tɛ̀ːsən/
testọ̑	/tɛstóː/
téta	/tɛ̀ːta/
tẹ́ti	/tèːti/
tetovȋranje	/tɛtɔʋíːranjɛ/
tetovȋrati	/tɛtɔʋíːrati/
téžək	/tɛ̀ːʒək/
tẹ̑žji	/téːʒji/
-ti	/-ti/
tȋ	/tíː/
	
tȋh	/tíːx/
tīkati	/tìːkati/
tȋmijan	/tíːmijan/
tȋp	/tíːp/
tȋpka	/tíːpka/
tipkȏvnica	/tipkɔ́ːʋnit͡sa/
tȋsa	/tíːsa/
tȋsoč	/tíːsɔt͡ʃ/
tisočlẹ̑tje	/tisɔt͡ʃléːtjɛ/
tȋsti	/tíːsti/
tišína	/tiʃìːna/
titȃn	/titáːn/
tjūlənj	/tjùːlən/
Tkȃləc	/tkáːlət͡s/
tkáti	/tkàːti/
tkívo	/tkìːʋɔ/
tlȁ	/tlá/
tlȃk	/tláːk/
tọ̑	/tóː/
točȋlna míza	/tɔt͡ʃíːlna mìːza/
tọ̄d	/tòːt/
tọ̑da	/tɔda/
tọ̑g	/tóːk/
tọ̑k	/tóːk/
tokȃta	/tɔkáːta/
tółči	/tɔ̀ːʋt͡ʃi/
tołkálo	/tɔʋkàːlɔ/
tolmáč	/tɔlmàːt͡ʃ/
tólpa	/tɔ̀ːlpa/
tọ̑m	/tóːm/
tomahȃvk	/tɔmaxáːʋk/
Tomȃž	/tɔmáːʃ/
tȍp	/tɔ́p/
tópəł	/tɔ̀ːpəʋ/
topīti	/tɔpìːti/
toplóta	/tɔplɔ̀ːta/
tọ̑rba	/tóːrba/
tórək	/tɔ̀ːrək/
tọ́rij	/tòːrij/
tovȃriš	/tɔʋáːriʃ/
tožȋlnik	/tɔʒíːlnik/
tradícija	/tradìːt͡sija/
tradicionȃlən	/tradit͡siɔnáːlən/
trajẹ̑kt	/trajéːkt/
trakúlja	/trakùːlja/
trȃmvaj	/tráːmʋaj/
Transilvánija	/transilʋàːnija/
tráva	/tràːʋa/
trāvnik	/tràːʋnik/
travojẹ̑dəc	/traʋɔjéːdət͡s/
tȓd	/tə́rt/
trdnjȃva	/tərdnjáːʋa/
trẹ́buh	/trèːbux/
trebȗšna slínavka	/trɛbúːʃna slìːnaʋka/
trenȇr	/trɛnɛ́ːr/
trenȗtək	/trɛnúːtək/
trepȃlnica	/trɛpáːlnit͡sa/
trẹ́sti	/trèːsti/
trẹ́ti	/trèːti/
Tretják	/trɛtjàːk/
tȓg	/tə́rk/
tŕgati	/tə̀rɡati/
trgovína	/tərɡɔʋìːna/
trȋ	/tríː/
triángəl	/trijàːnɡəl/
trȋdeset	/tríːdɛsɛt/
trȋje	/tríːjɛ/
trikọ̑tnik	/trikóːtnik/
trinájst	/trinàːjst/
Trȋnko	/tríːnkɔ/
trȋs	/tríːs/
trizọ̑b	/trizóːp/
trobẹ̑nta	/trɔbéːnta/
Trọ̑št	/tróːʃt/
trọ̑t	/tróːt/
trpẹ́ti	/tərpèːti/
tŕska	/tə̀rska/
Tȓst	/tə́rst/
Trstenják	/tərstɛnjàːk/
tȓši	/tə́rʃi/
trúplo	/trùːplɔ/
tȕ	/tú/
tuberkulọ̑za	/tubɛrkulóːza/
tȗdi	/túːdi/
tȗkaj	/túːkaj/
túlij	/tùːlij/
tuljȃva	/tuljáːʋa/
Tunízija	/tunìːzija/
Tȗrčija	/túːrt͡ʃija/
Túrək	/tùːrək/
turȋst	/turíːst/
turízəm	/turìːzəm/
Túrkinja	/tùːrkinja/
turóbən	/turɔ̀ːbən/
túrščina	/tùːrʃt͡ʃina/
túrški	/tùːrʃki/
túrško	/tùːrʃkɔ/
tvẹ̄ganje	/tʋèːɡanjɛ/
tvẹ̄gati	/tʋèːɡati/
tvọ́j	/tʋòːj/
tvọ̑rba	/tʋóːrba/
tvọ̄riti	/tʋòːriti/
u-	/u-/
ubẹ́žna hitrọ̑st	/ubèːʒna xitróːst/
ubíti	/ubìːti/
ubọ̑g	/ubóːk/
učénəc	/ut͡ʃɛ̀ːnət͡s/
učȋnək	/ut͡ʃíːnək/
učȋtelj	/ut͡ʃíːtɛl/
učȋteljica	/ut͡ʃíːtɛljit͡sa/
učīti	/ut͡ʃìːti/
ȗd	/úːt/
udáriti	/udàːriti/
ugrabȋtəv	/uɡrabíːtəʋ/
ugrȋz	/uɡríːs/
ugrízniti	/uɡrìːzniti/
uhọ̑	/uxóː/
ūjəc	/ùːjət͡s/
ujẹ̄da	/ujèːda/
ujẹ́ti	/ujèːti/
ukȁz	/ukás/
Ukrajína	/ukrajìːna/
ukrajȋnski	/ukrajíːnski/
ukrásti	/ukràːsti/
ukvárjati	/ukʋàːrjati/
ulic	/ˈulits/
úlica	/ùːlit͡sa/
ulice	/ˈulit͡sɛ/
ulici	/ˈulit͡si/
ulico	/uˈlit͡sɔ/
ulọ̑mək	/ulóːmək/
ȗltrakratkovalȏvən	/úːltrakratkɔʋalɔ́ːʋən/
umȃzan	/umáːzan/
umẹ́ti	/umèːti/
umẹ̑tnik	/uméːtnik/
umíti	/umìːti/
umívati	/umìːʋati/
umȍr	/umɔ́r/
umorīti	/umɔrìːti/
umrẹ́ti	/umrèːti/
unifọ̑rma	/unifóːrma/
univȇrza	/uniʋɛ́ːrza/
ȗpanje	/úːpanjɛ/
ȗpati	/úːpati/
uplinjáč	/uplinjàːt͡ʃ/
upȍr	/upɔ́r/
uporȃba	/upɔráːba/
uporabīti	/upɔrabìːti/
uporábljati	/upɔràːbljati/
uporȃbnik	/upɔráːbnik/
ūra	/ùːra/
urȃdən	/uráːdən/
urȃn	/uráːn/
Urȃn	/uráːn/
urbȃn	/urbáːn/
Urbȁn	/urbán/
ȗrnik	/úːrnik/
urȍk	/urɔ́k/
klobučár	/klɔbut͡ʃàːr/
rẹ̑d	/réːt/
do	/dÉ”/
vratȉč	/ʋratít͡ʃ/
otáva	/ɔtàːʋa/
slȁb	/sláp/
zgréšiti	/zɡrɛ̀ːʃiti/
vółga	/ʋɔ̀ːʋɡa/
čẹ́maž	/t͡ʃèːmaʃ/
se	/sɛ/
odrešeník	/ɔdrɛʃɛnìːk/
gáms	/ɡàːms/
lẹ́šnik	/lèːʃnik/
vọ̑jvodina	/ʋóːjʋɔdina/
mīrna Bọ̑sna	/mìːrna bóːsna/
dóbro jútro	/dɔ̀ːbrɔ jùːtrɔ/
diják	/dijàːk/
podgána	/pɔdɡàːna/
medeníca	/mɛdɛnìːt͡sa/
kẹ́lih	/kèːlix/
uslȗga	/uslúːɡa/
usmrtȋtəv	/usmərtíːtəʋ/
úsnje	/ùːsnjɛ/
usọ̑da	/usóːda/
usọ́dən	/usòːdən/
usọ́dnejši	/usòːdnɛjʃi/
uspȅh	/uspɛ́x/
uspẹ́ti	/uspèːti/
ústa	/ùːsta/
ustȃva	/ustáːʋa/
ūstje	/ùːstjɛ/
ȗstnica	/úːstnit͡sa/
ustrẹ́zən	/ustrèːzən/
ustrẹ́znejši	/ustrèːznɛjʃi/
ustrẹ́znik	/ustrèːznik/
ȗš	/úːʃ/
utrújati	/utrùːjati/
utrújen	/utrùːjɛn/
uvẹ́ł	/uʋèːʋ/
užívati	/uʒìːʋati/
v	/ʋ/
v žȋvo	/ʋ ʒíːʋɔ/
v-	/ʋ-/
váditi	/ʋàːditi/
vȃga	/ʋáːɡa/
vagȋna	/ʋaɡíːna/
vaginȃlni sẹ̑ks	/ʋaɡináːlni séːks/
vȃjin	/ʋáːjin/
vȃl	/ʋáːl/
Valentȋn	/ʋalɛntíːn/
vālj	/ʋàːl/
vampír	/ʋampìːr/
vanádij	/ʋanàːdij/
várən	/ʋàːrən/
várnejši	/ʋàːrnɛjʃi/
Varšȃva	/ʋarʃáːʋa/
vȃruh	/ʋáːrux/
vȃs	/ʋáːs/
vȁš	/ʋáʃ/
vaterpolȋst	/ʋatɛrpɔlíːst/
váterpọ̑lo	/ʋàːtɛrpóːlɔ/
váza	/ʋàːza/
včȃsih	/ʋt͡ʃáːsix/
včẹ́raj	/ʋt͡ʃèːraj/
včlāniti	/ʋt͡ʃlàːniti/
vdíhniti	/ʋdìːxniti/
vdȏva	/ʋdɔ́ːʋa/
vẹ̑	/ʋéː/
Vẹ́bər	/ʋèːbər/
vȅč	/ʋɛ́t͡ʃ/
vẹ́čən	/ʋèːt͡ʃən/
večẹ̑r	/ʋɛt͡ʃéːr/
večẹ̑rja	/ʋɛt͡ʃéːrja/
vẹ̑čji	/ʋéːt͡ʃji/
vẹ́deti	/ʋèːdɛti/
vẹ́dno	/ʋèːdnɔ/
védro	/ʋɛ̀ːdrɔ/
vegetarijȃnəc	/ʋɛɡɛtarijáːnət͡s/
vȇja	/ʋɛ́ːja/
vȇjati	/ʋɛ́ːjati/
vȇjica	/ʋɛ́ːjit͡sa/
vẹ́ktor	/ʋèːktɔr/
	
velẹ̑lnik	/ʋɛléːlnik/
vȅleposlánik	/ʋɛ́lɛpɔslàːnik/
vȅleposláništvo	/ʋɛ́lɛpɔslàːniʃtʋɔ/
veličína	/ʋɛlit͡ʃìːna/
vélik	/ʋɛ̀ːlik/
Vẹ̑lika Británija	/ʋéːlika britàːnija/
Vẹ̑lika nọ̑č	/ʋɛlìːka nóːt͡ʃ/
vẹ̑lika siníca	/ʋéːlika sinìːt͡sa/
vẹ̑lika ȗharica	/ʋéːlika úːxarit͡sa/
velikȃn	/ʋɛlikáːn/
velíko	/ʋɛlìːkɔ/
və̀ndar	/ʋə̀ndar/
Vẹ̑nera	/ʋéːnɛra/
vẹ́niti	/ʋèːniti/
vẹ́ra	/ʋèːra/
veríga	/ʋɛrìːɡa/
verjẹ́ti	/ʋɛrjèːti/
və̏s	/ʋə́s/
vesẹ̑ł	/ʋɛséːʋ/
vesélje	/ʋɛsɛ̀ːljɛ/
vẹ́siti	/ʋèːsiti/
vẹ̑st	/ʋéːst/
vésti	/ʋɛ̀ːsti/
vẹ̑tər	/ʋéːtər/
vẹ́ti	/ʋèːti/
vẹ́verica	/ʋèːʋɛrit͡sa/
vẹ̑z	/ʋéːs/
‎vẹ́zati	/ʋèːzati/
vẹ̑znik	/ʋéːznik/
vhȍd	/ʋxɔ́t/
vȋ	/ʋíː/
vīce	/ʋìːt͡sɛ/
vȋd	/ʋíːt/
vídeti	/ʋìːdɛti/
vīdra	/ʋìːdra/
vihȃr	/ʋixáːr/
viják	/ʋijàːk/
vīkati	/ʋìːkati/
vȋla	/ʋíːla/
víle	/ʋìːlɛ/
vílice	/ʋìːlit͡sɛ/
víno	/ʋìːnɔ/
vinọ́grad	/ʋinòːɡrat/
violȋna	/ʋijɔlíːna/
violončẹ̑lo	/ʋijɔlɔnt͡ʃéːlɔ/
vȋr	/ʋíːr/
visẹ́ča mrẹ́ža	/ʋisèːt͡ʃa mrèːʒa/
visȍk	/ʋisɔ́k/
vȋšji	/ʋíːʃji/
Vȋšnu	/ʋíːʃnu/
vȋtez	/ʋíːtɛs/
víti	/ʋìːti/
	/ˈviːzʊm/
vkljúčiti	/ʋkljùːt͡ʃiti/
vklopīti	/ʋklɔpìːti/
vlȃda	/ʋláːda/
vlādati	/ʋlàːdati/
vladavína	/ʋladaʋìːna/
vlȃk	/ʋláːk/
vlẹ́či	/ʋlèːt͡ʃi/
vljúdnost	/ʋljùːdnɔst/
Vl̏tava	/ʋə́ltaʋa/
vnūk	/ʋnùːk/
vnūkinja	/ʋnùːkinja/
vóda	/ʋɔ̀ːda/
vodȉč	/ʋɔdít͡ʃ/
vodȋk	/ʋɔdíːk/
vodīti	/ʋɔdìːti/
vọ̑dja	/ʋóːdja/
Vodnár	/ʋɔdnàːr/
vọ̑dnica	/ʋóːdnit͡sa/
vodọ̄məc	/ʋɔdòːmət͡s/
vogȃł	/ʋɔɡáːʋ/
vohȗn	/ʋɔxúːn/
vohȗnski	/ʋɔxúːnski/
voják	/ʋɔjàːk/
vojákinja	/ʋɔjàːkinja/
vójna	/ʋɔ̀ːjna/
vójska	/ʋɔ̀ːjska/
vojščák	/ʋɔjʃt͡ʃàːk/
vọ̑jvoda	/ʋóːjʋɔda/
Vọ̑jvodina	/ʋóːjʋɔdina/
vọ̑jvodina	/ʋóːjʋɔdina/
vȍł	/ʋɔ́ʋ/
volȃn	/ʋɔláːn/
vọ̑lfram	/ʋóːlfram/
vółga	/ʋɔ̀ːʋɡa/
vọ́lja	/ʋòːlja/
vȏłk	/ʋɔ́ːʋk/
Vȏlk	/ʋɔ́ːʋk/
vołkodlȃk	/ʋɔʋkɔdláːk/
vółna	/ʋɔ̀ːʋna/
volȗhar	/ʋɔlúːxar/
vọ̑sək	/ʋóːsək/
voščílo	/ʋɔʃt͡ʃìːlɔ/
voščīti	/ʋɔʃt͡ʃìːti/
Vȏvk	/ʋɔ́ːʋk/
vọ̑z	/ʋóːs/
vózəł	/ʋɔ̀ːzəʋ/
vozīti	/ʋɔzìːti/
vóžnja	/ʋɔ̀ːʒnja/
vpíti	/ʋpìːti/
vplȋv	/ʋplíːʋ/
vprašȃj	/ʋpraʃáːj/
vprašȃnje	/ʋpraʃáːnjɛ/
vprášati	/ʋpràːʃati/
vrábəc	/ʋràːbət͡s/
vrȃn	/ʋráːn/
Vrȃn	/ʋráːn/
vrána	/ʋràːna/
vránica	/ʋràːnit͡sa/
vrȃt	/ʋráːt/
vráta	/ʋràːta/
vratȉč	/ʋratít͡ʃ/
vráža	/ʋràːʒa/
vŕba	/ʋə̀rba/
vȓč	/ʋə́rt͡ʃ/
vrẹ́či	/ʋrèːt͡ʃi/
vrẹ́dnost	/ʋrèːdnɔst/
vréme	/ʋrɛ̀ːmɛ/
vreténce	/ʋrɛtɛ̀ːnt͡sɛ/
vrẹ́ti	/ʋrèːti/
vrȍč	/ʋrɔ́t͡ʃ/
vȓst	/ʋə́rst/
vŕsta	/ʋə̀rsta/
vȓstən	/ʋə́rstən/
vrstȋlən	/ʋərstíːlən/
vȓstnost	/ʋə́rstnɔst/
vŕša	/ʋə̀rʃa/
vršȋləc	/ʋərʃíːlət͡s/
vȓt	/ʋə́rt/
vȓtnica	/ʋə́rtnit͡sa/
vsȃj	/ʋsáːj/
vsebína	/ʋsɛbìːna/
vsejẹ̑dəc	/ʋsɛjéːdət͡s/
vstáviti	/ʋstàːʋiti/
vstọ̄pati	/ʋstòːpati/
klobučár	/klɔbut͡ʃàːr/
rẹ̑d	/réːt/
do	/dÉ”/
vratȉč	/ʋratít͡ʃ/
otáva	/ɔtàːʋa/
slȁb	/sláp/
zgréšiti	/zɡrɛ̀ːʃiti/
vółga	/ʋɔ̀ːʋɡa/
čẹ́maž	/t͡ʃèːmaʃ/
se	/sɛ/
odrešeník	/ɔdrɛʃɛnìːk/
gáms	/ɡàːms/
lẹ́šnik	/lèːʃnik/
vọ̑jvodina	/ʋóːjʋɔdina/
mīrna Bọ̑sna	/mìːrna bóːsna/
dóbro jútro	/dɔ̀ːbrɔ jùːtrɔ/
diják	/dijàːk/
podgána	/pɔdɡàːna/
medeníca	/mɛdɛnìːt͡sa/
kẹ́lih	/kèːlix/
vstopīti	/ʋstɔpìːti/
všẹ̑č	/ʋʃéːt͡ʃ/
všẹ́čən	/ʋʃèːt͡ʃən/
všẹ́čnost	/ʋʃèːt͡ʃnɔst/
vtȋs	/ʋtíːs/
vulkȃn	/ʋulkáːn/
Vȗrnik	/ʋúːrnik/
vz-	/ʋz-/
vzẹ́ti	/ʋzèːti/
vzhȍd	/ʋzxɔ́t/
vzhọ̑dən	/ʋzxóːdən/
vzhọ̑dnejši	/ʋzxóːdnɛjʃi/
vzpȍn	/ʋspɔ́n/
vžigȃlica	/ʋʒiɡáːlit͡sa/
Wikipedȋja	/ʋikipɛdíːja/
Wikislovár	/ʋikislɔʋàːr/
z	/s/
z-	/z-/
za	/za/
za-	/za-/
zabȃva	/zabáːʋa/
Zabȃvnik	/zabáːʋnik/
začẹ̑tək	/zat͡ʃéːtək/
začẹ̑tən	/zat͡ʃéːtən/
začẹ́ti	/zat͡ʃèːti/
zȃdnji	/záːdnji/
zȃdnjica	/záːdnjit͡sa/
zȃdnjičən	/záːdnjit͡ʃən/
zȃdnjik	/záːdnjik/
zadovoljeváti	/zadɔʋɔljɛʋàːti/
zadovoljīti	/zadɔʋɔljìːti/
zagnáti	/zaɡnàːti/
zahȍd	/zaxɔ́t/
zahọ̑dən	/zaxóːdən/
Zahọ̑dna Evrọ̑pa	/zaxóːdna ɛʋróːpa/
Zahọ̑dna Sahȃra	/zaxóːdna saxáːra/
zahọ̑dnejši	/zaxóːdnɛjʃi/
zahtẹ̑va	/zaxtéːʋa/
zaȋmək	/zaíːmək/
zaíti	/zaìːti/
zȃjəc	/záːjət͡s/
Zȃjəc	/záːjət͡s/
zājtrk	/zàːjtərk/
zajtrkováti	/zajtərkɔʋàːti/
zakāj	/zakàːj/
zaklȁd	/zaklát/
zaklenīti	/zaklɛnìːti/
zákon	/zàːkɔn/
zakristȋja	/zakristíːja/
Zȃlar	/záːlar/
zalȋv	/zalíːʋ/
zaljubīti	/zaljubìːti/
zamȁn	/zamán/
Zámbija	/zàːmbija/
zamudīti	/zamudìːti/
zanimīv	/zanimìːʋ/
zanimívejši	/zanimìːʋɛjʃi/
zapẹ̑stje	/zapéːstjɛ/
zapȍr	/zapɔ́r/
zapọ̑rnik	/zapóːrnik/
zaprẹ́ti	/zaprèːti/
zapustīti	/zapustìːti/
zaradi drevẹ̑s ne vídeti gózda	/zaradi drɛʋéːs nɛ ʋìːdɛti ɡɔ̀ːzda/
Zȃrnik	/záːrnik/
zasẹ̑bən	/zaséːbən/
zaspán	/zaspàːn/
zaspáti	/zaspàːti/
zastȃva	/zastáːʋa/
zastȃvnica	/zastáːʋnit͡sa/
zaščȋta	/zaʃt͡ʃíːta/
zavẹ̑sa	/zaʋéːsa/
zavrẹ́ti	/zaʋrèːti/
zažgáti	/zaʒɡàːti/
zbežáti	/zbɛʒàːti/
zbīrati	/zbìːrati/
zbȋrka	/zbíːrka/
zbráti	/zbràːti/
zdȁj	/zdáj/
zdołgočȃsen	/zdɔʋɡɔt͡ʃáːsɛn/
zdrȁv	/zdráʋ/
zdravíca	/zdraʋìːt͡sa/
zdravílo	/zdraʋìːlɔ/
zdrȃvje	/zdráːʋjɛ/
zdravljíca	/zdraʋljìːt͡sa/
zdravník	/zdraʋnìːk/
zdrȃvo	/zdráːʋɔ/
zdrȃvstvo	/zdráːʋstʋɔ/
Zdrūžene držȃve Amȇrike	/zdrùːʒɛnɛ dərʒáːʋɛ amɛ́ːrikɛ/
Zdrūženo kraljẹ̑stvo	/zdrùːʒɛnɔ kraljéːstʋɔ/
zẹ̄bra	/zèːbra/
zẹ́bsti	/zèːpsti/
zẹ́hati	/zèːxati/
zə̏ł	/zə́ʋ/
zelȅn	/zɛlɛ́n/
zẹ̑lena	/zéːlɛna/
zelẹ̑ni čȃj	/zɛléːni t͡ʃáːj/
Zelenoȓtski otọ́ki	/zɛlɛnɔə́rtski ɔtòːki/
zẹ́lje	/zèːljɛ/
zelọ̑	/zɛlóː/
zémlja	/zɛ̀ːmlja/
Zémlja	/zɛ̀ːmlja/
zemljepȋs	/zɛmljɛpíːs/
zemljevȋd	/zɛmljɛʋíːt/
zeníca	/zɛnìːt͡sa/
zȅt	/zɛ́t/
zgọ̑daj	/zɡóːdaj/
zgọ̑dba	/zɡóːdba/
zgodovína	/zɡɔdɔʋìːna/
zgodovȋnski	/zɡɔdɔʋíːnski/
zgóraj	/zɡɔ̀ːraj/
zgrȃdba	/zɡráːdba/
zgréšiti	/zɡrɛ̀ːʃiti/
zíbati	/zìːbati/
zȋd	/zíːt/
zídati	/zìːdati/
zíma	/zìːma/
zjútraj	/zjùːtraj/
zlȃt	/zláːt/
zlātən	/zlàːtən/
zláti rẹ̑z	/zlàːti réːs/
zlatọ̑	/zlatóː/
zlemȕ	/zlɛmú/
zlītina	/zlìːtina/
zlȍ	/zlɔ́/
zločȋn	/zlɔt͡ʃíːn/
zlȍg	/zlɔ́k/
zlomīti	/zlɔmìːti/
zlọ́mljen	/zlòːmljɛn/
zlonamẹ́rən	/zlɔnamèːrən/
zmȃga	/zmáːɡa/
zmagovȃləc	/zmaɡɔʋáːlət͡s/
zmāj	/zmàːj/
zmẹ̑raj	/zméːraj/
značȋlən	/znat͡ʃíːlən/
značȋlnejši	/znat͡ʃíːlnɛjʃi/
znȃnje	/znáːnjɛ/
znánost	/znàːnɔst/
znȃnstven	/znáːnstʋɛn/
znáti	/znàːti/
znọ̑j	/znóːj/
znọ́traj	/znòːtraj/
zọ̑b	/zóːp/
zọ́bər	/zòːbər/
zobozdravník	/zɔbɔzdraʋnìːk/
zobozdrȃvstvo	/zɔbɔzdráːʋstʋɔ/
zọ̑na	/zóːna/
zóra	/zɔ̀ːra/
zorẹ́ti	/zɔrèːti/
zrȁk	/zrák/
zrȅł	/zrɛ́ʋ/
zrẹ́lejši	/zrèːlɛjʃi/
zŕklo	/zə̀rklɔ/
ZSSR	/zəsəsərə́/
zúnaj	/zùːnaj/
Zȗpan	/zúːpan/
Zȗpanc	/zúːpant͡s/
zváti	/zʋàːti/
zvečẹ̑r	/zʋɛt͡ʃéːr/
zvẹ̑r	/zʋéːr/
Zvẹ̑r	/zʋéːr/
zverína	/zʋɛrìːna/
zvẹ́zda	/zʋèːzda/
zvẹ̑zək	/zʋéːzək/
zvȋtək	/zʋíːtək/
zvọ̑k	/zʋóːk/
zvọ̑n	/zʋóːn/
Zvonár	/zʋɔnàːr/
Zvọ̑ne	/zʋóːnɛ/
zvónəc	/zʋɔ̀ːnət͡s/
Ž	/ʒ/
žába	/ʒàːba/
žafrȃn	/ʒafráːn/
žȃga	/ʒáːɡa/
žȃgati	/ʒáːɡati/
žálik žéna	/ʒàːlik ʒɛ̀ːna/
žálost	/ʒàːlɔst/
žámet	/ʒàːmɛt/
žára	/ʒàːra/
žȃrək	/ʒáːrək/
ždẹ́ti	/ʒdèːti/
žẹ̑	/ʒéː/
žebə̏lj	/ʒɛbə́l/
želẹ́ti	/ʒɛlèːti/
želẹ́zna zavẹ̑sa	/ʒɛlèːzna zaʋéːsa/
želẹ́zo	/ʒɛlèːzɔ/
žélja	/ʒɛ̀ːlja/
želọ̑dəc	/ʒɛlóːdət͡s/
žẹ́lva	/ʒèːlʋa/
žéna	/ʒɛ̀ːna/
žẹ́nska	/ʒèːnska/
žẹ́nski	/ʒèːnski/
žȅp	/ʒɛ́p/
žȇpar	/ʒɛ́ːpar/
žerjȁv	/ʒɛrjáʋ/
Žerjȁv	/ʒɛrjáʋ/
žẹ̑təv	/ʒéːtəʋ/
žẹ́ti	/ʒèːti/
žgáti	/ʒɡàːti/
žíca	/ʒìːt͡sa/
žíla	/ʒìːla/
klobučár	/klɔbut͡ʃàːr/
rẹ̑d	/réːt/
do	/dÉ”/
vratȉč	/ʋratít͡ʃ/
otáva	/ɔtàːʋa/
slȁb	/sláp/
zgréšiti	/zɡrɛ̀ːʃiti/
vółga	/ʋɔ̀ːʋɡa/
čẹ́maž	/t͡ʃèːmaʃ/
se	/sɛ/
odrešeník	/ɔdrɛʃɛnìːk/
gáms	/ɡàːms/
lẹ́šnik	/lèːʃnik/
vọ̑jvodina	/ʋóːjʋɔdina/
mīrna Bọ̑sna	/mìːrna bóːsna/
dóbro jútro	/dɔ̀ːbrɔ jùːtrɔ/
diják	/dijàːk/
podgána	/pɔdɡàːna/
medeníca	/mɛdɛnìːt͡sa/
kẹ́lih	/kèːlix/
žirȃfa	/ʒiráːfa/
žíti	/ʒìːti/
žȋv	/ʒíːʋ/
živáhən	/ʒiʋàːxən/
živáhnejši	/ʒiʋàːxnɛjʃi/
živȃł	/ʒiʋáːʋ/
živẹ́ti	/ʒiʋèːti/
življénje	/ʒiʋljɛ̀ːnjɛ/
žívo srebrọ̑	/ʒìːʋɔ srɛbróː/
žlẹ́za	/ʒlèːza/
žọ̄ga	/ʒòːɡa/
žȏłč	/ʒɔ́ːʋt͡ʃ/
žȏłčnik	/ʒɔ́ːʋt͡ʃnik/
žółna	/ʒɔ̀ːʋna/
žȏłt	/ʒɔ́ːʋt/
žrebȅ	/ʒrɛbɛ́/
žrẹ́bəc	/ʒrèːbət͡s/
žrebíca	/ʒrɛbìːt͡sa/
žrẹ́ti	/ʒrèːti/
žrtvováti	/ʒərtʋɔʋàːti/
žužẹ̑lka	/ʒuʒéːlka/
žvẹ́čiti	/ʒʋèːt͡ʃiti/
žvéplo	/ʒʋɛ̀ːplɔ/
