зи́мородок	zýmorodok	[ˈzɪmɔrɔdɔk]
леле́ка	leléka	[leˈlɛkɐ]
Львів	Lʹviv	[lʲˈʋʲiu̯]
кия́нин	kyjányn	[keˈjɑnen]
кна́йпа	knájpa	[ˈknɑi̯pɐ]
число́	čysló	[t͡ʃeˈslɔ]
лише́	lyšé	[leˈʃɛ]
глід	hlid	[ˈɦlʲid]
берескле́т	bruslýna	[bereˈsklɛt]
	porá róku	[seˈzɔn]
ка́федра	káfedra	[ˈkɑfedrɐ]
ва́ше	váše	[ˈʋɑʃe]
украї́нець	ukrajínecʹ	[ʊkrɐˈjinet͡sʲ]
Я́ків	Jákiv	/ˈjɑkiu̯/
вона́	voná	[wɔˈnɑ]
воно́	vonó	[wɔˈnɔ]
вони́	voný	[wɔˈnɪ]
горі́лки	horílky	/ɦoˈrilkɪ/
англі́йський	Ánhlija	[ɐnˈɦlʲii̯sʲkei̯]
депута́т	deputát	[depʊˈtɑt]
Є́ва	Jéva	[ˈjɛu̯ɐ]
Євге́н	Jevhén	[jeu̯ˈɦɛn]
Євге́нія	Jevhénija	[jeu̯ˈɦɛnʲijɐ]
євразі́йський	jevrazíjsʹkyj	[jeu̯rɐˈzʲii̯sʲkei̯]
Євро́па	Jevrópa	[jeu̯ˈrɔpɐ]
європе́йський	jevropéjsʹkyj	[jeu̯rɔˈpɛi̯sʲkei̯]
Ñ–	i	[Ëˆi]
Іва́н	Iván	[iˈu̯ɑn]
Іва́нна	Ivánna	[iˈu̯ɑnːɐ]
іде́я	idéja	[iˈdɛjɐ]
Іло́на	Ilóna	[iˈlɔnɐ]
ім'я́	imʺjá	[iˈmjɑ]
іме́нник	iménnyk	[iˈmɛnːek]
імуноло́гія	imunolóhija	[imʊnɔˈlɔɦʲijɐ]
ініціати́ва	iniciatýva	[inʲit͡sʲiɐˈtɪu̯ɐ]
інвалі́д	invalíd	[inʋɐˈlʲid]
інвести́ція	investýcija	[inʋeˈstɪt͡sʲijɐ]
інве́стор	invéstor	[inˈʋɛstɔr]
інді́йський	indíjsʹkyj	[inʲˈdʲii̯sʲkei̯]
інквілі́н	inkvilín	/inkviˈlin/
і́нколи	ínkoly	/ˈinkolɪ/
І́нна	Ínna	[ˈinːɐ]
інститу́т	instytút	[insteˈtut]
інстру́кціє	instrúkcije	[inˈstrukt͡sʲije]
інстру́кцією	instrúkcijeju	[inˈstrukt͡sʲijejʊ]
інстру́кції	instrúkciji	[inˈstrukt͡sʲiji]
інстру́кцій	instrúkcij	[inˈstrukt͡sʲii̯]
інстру́кцію	instrúkciju	[inˈstrukt͡sʲijʊ]
інстру́кція	instrúkcija	[inˈstrukt͡sʲijɐ]
інстру́кціям	instrúkcijam	[inˈstrukt͡sʲijɐm]
інстру́кціями	instrúkcijamy	[inˈstrukt͡sʲijɐme]
інстру́кціях	instrúkcijax	[inˈstrukt͡sʲijɐx]
інструме́нт	instrumént	[instrʊˈmɛnt]
інтегра́ція	intehrácija	[inteˈɦrɑt͡sʲijɐ]
інтерв'ю́	intervʺjú	[interˈʋju]
інтере́с	interés	[inteˈrɛs]
інформа́тика	informátyka	[infɔrˈmɑtekɐ]
інформа́ція	informácija	[infɔrˈmɑt͡sʲijɐ]
і́нший	ínšyj	/ˈinʃɪj/
Іри́на	Irýna	[iˈrɪnɐ]
існува́ння	isnuvánnja	[isnʊˈu̯ɑnʲːɐ]
і́стина	ístyna	[ˈistenɐ]
істо́рія	istórija	[iˈstɔrʲijɐ]
істо́та	istóta	[iˈstɔtɐ]
-ість	-istʹ	[-ˈisʲtʲ]
Іта́лія	Itálija	[iˈtɑlʲijɐ]
іша́к	išák	[iˈʃɑk]
ї	ji	/ji/
її́	jijí	[jiˈji]
ї́жа	jíža	[ˈjiʒɐ]
їжа́к	jižák	[jiˈʒɑk]
ї́сти	jísty	/ˈjistɪ/
їх	jix	[ˈjix]
а	a	[ˈɑ]
А	A	[ˈɑ]
аб'юра́ція	abʺjurácija	[ɐbjʊˈrɑt͡sʲijɐ]
абіогене́з	abiohenéz	[ɐbʲiɔɦeˈnɛz]
абіса́ль	abisálʹ	[ɐbʲiˈsɑlʲ]
абіссі́нець	abissínecʹ	[ɐbʲiˈsʲːinet͡sʲ]
абіссі́нка	abissínka	[ɐbʲiˈsʲːinkɐ]
абітуріє́нт	abiturijént	[ɐbʲitʊrʲiˈjɛnt]
абітуріє́нтка	abiturijéntka	[ɐbʲitʊrʲiˈjɛntkɐ]
абажу́р	abažúr	[ɐbɐˈʒur]
абажу́рчик	abažúrčyk	[ɐbɐˈʒurt͡ʃek]
аба́з	abáz	[ɐˈbɑz]
аба́зія	abázija	[ɐˈbɑzʲijɐ]
абази́н	abazýn	[ɐbɐˈzɪn]
абази́нець	abazýnecʹ	[ɐbɐˈzɪnet͡sʲ]
абази́нка	abazýnka	[ɐbɐˈzɪnkɐ]
аба́к	abák	[ɐˈbɑk]
аба́ка	abáka	[ɐˈbɑkɐ]
абандо́н	abandón	[ɐbɐnˈdɔn]
аба́т	abát	[ɐˈbɑt]
абати́са	abatýsa	[ɐbɐˈtɪsɐ]
аба́тство	abátstvo	[ɐˈbɑt͡stwɔ]
а́бвер	ábver	[ˈɑbʋer]
абдика́ція	abdykácija	[ɐbdeˈkɑt͡sʲijɐ]
абдомінопла́стика	abdominoplástyka	[ɐbdɔmʲinɔˈplɑstekɐ]
абера́ція	aberácija	[ɐbeˈrɑt͡sʲijɐ]
абе́тка	a	[ɐˈbɛtkɐ]
абеткува́ння	abetkuvánnja	[ɐbetkʊˈu̯ɑnʲːɐ]
абза́ц	abzác	[ɐˈbzɑt͡s]
аби́щиця	abýščycja	[ɐˈbɪʃt͡ʃet͡sʲɐ]
аблактува́ння	ablaktuvánnja	[ɐblɐktʊˈu̯ɑnʲːɐ]
абла́стика	ablástyka	[ɐˈblɑstekɐ]
аблати́в	ablatýv	[ɐblɐˈtɪu̯]
абля́ція	abljácija	[ɐˈblʲɑt͡sʲijɐ]
аболіціоні́зм	abolicionízm	[ɐbɔlʲit͡sʲioˈnʲizm]
аболіціоні́ст	abolicioníst	[ɐbɔlʲit͡sʲioˈnʲist]
аболі́ція	abolícija	[ɐboˈlʲit͡sʲijɐ]
абонеме́нт	abonemént	[ɐbɔneˈmɛnt]
абоне́нт	abonént	[ɐbɔˈnɛnt]
абоне́нтка	abonéntka	[ɐbɔˈnɛntkɐ]
абонува́ння	abonuvánnja	[ɐbɔnʊˈu̯ɑnʲːɐ]
аборда́ж	abordáž	[ɐbɔrˈdɑʒ]
абориге́н	aboryhén	[ɐbɔreˈɦɛn]
абориге́нка	aboryhénka	[ɐbɔreˈɦɛnkɐ]
або́рт	abórt	[ɐˈbɔrt]
абортува́ння	abortuvánnja	[ɐbɔrtʊˈu̯ɑnʲːɐ]
абра́зія	abrázija	[ɐˈbrɑzʲijɐ]
абрази́в	abrazýv	[ɐbrɐˈzɪu̯]
абрази́вність	abrazývnistʹ	[ɐbrɐˈzɪu̯nʲisʲtʲ]
абракада́бра	abrakadábra	[ɐbrɐkɐˈdɑbrɐ]
абракадабри́зм	abrakadabrýzm	[ɐbrɐkɐdɐˈbrɪzm]
абревіа́ція	abreviácija	[ɐbreu̯ʲiˈɑt͡sʲijɐ]
абреже́	abrežé	[ɐbreˈʒɛ]
абре́к	abrék	[ɐˈbrɛk]
абрико́с	abrykós	[ɐbreˈkɔs]
абрико́сівка	abrykósivka	[ɐbreˈkɔsʲiu̯kɐ]
абрико́са	abrykósa	[ɐbreˈkɔsɐ]
абрико́сник	abrykósnyk	[ɐbreˈkɔsnek]
абрикоти́н	abrykotýn	[ɐbrekɔˈtɪn]
а́брис	ábrys	[ˈɑbres]
аброга́ція	abrohácija	[ɐbrɔˈɦɑt͡sʲijɐ]
абрупти́в	abruptýv	[ɐbrʊˈptɪu̯]
абса́нс	absáns	[ɐˈbsɑns]
абсе́нт	absént	[ɐˈbsɛnt]
абсентеї́зм	absentejízm	[ɐbsenteˈjizm]
абси́да	absýda	[ɐˈbsɪdɐ]
абсолю́т	absoljút	[ɐbsoˈlʲut]
абсолютиза́ція	absoljutyzácija	[ɐbsɔlʲʊteˈzɑt͡sʲijɐ]
абсолюти́зм	absoljutýzm	[ɐbsɔlʲʊˈtɪzm]
абсолютизува́ння	absoljutyzuvánnja	[ɐbsɔlʲʊtezʊˈu̯ɑnʲːɐ]
абсолюти́ст	absoljutýst	[ɐbsɔlʲʊˈtɪst]
абсолюти́стка	absoljutýstka	[ɐbsɔlʲʊˈtɪstkɐ]
абсолю́тність	absoljútnistʹ	[ɐbsoˈlʲutʲnʲisʲtʲ]
абсолю́ція	absoljúcija	[ɐbsoˈlʲut͡sʲijɐ]
абсорбе́нт	absorbént	[ɐbsɔrˈbɛnt]
абсо́рбер	absórber	[ɐˈbsɔrber]
абсорбува́ння	absorbuvánnja	[ɐbsɔrbʊˈu̯ɑnʲːɐ]
абсорбціо́метр	absorbciómetr	[ɐbsɔrbt͡sʲiˈɔmetr]
абсо́рбція	absórbcija	[ɐˈbsɔrbt͡sʲijɐ]
абстине́нт	abstynént	[ɐbsteˈnɛnt]
абстине́нтка	abstynéntka	[ɐbsteˈnɛntkɐ]
абстине́нція	abstynéncija	[ɐbsteˈnɛnʲt͡sʲijɐ]
абстраго́ваність	abstrahóvanistʹ	[ɐbstrɐˈɦɔu̯ɐnʲisʲtʲ]
абстрагува́ння	abstrahuvánnja	[ɐbstrɐɦʊˈu̯ɑnʲːɐ]
абстра́кт	abstrákt	[ɐˈbstrɑkt]
абстра́ктність	abstráktnistʹ	[ɐˈbstrɑktʲnʲisʲtʲ]
абстракціоні́зм	abstrakcionízm	[ɐbstrɐkt͡sʲioˈnʲizm]
абстракціоні́ст	abstrakcioníst	[ɐbstrɐkt͡sʲioˈnʲist]
абстракціоні́стка	abstrakcionístka	[ɐbstrɐkt͡sʲioˈnʲistkɐ]
абстра́кція	abstrákcija	[ɐˈbstrɑkt͡sʲijɐ]
абсу́рд	absúrd	[ɐˈbsurd]
абсурди́зм	absurdýzm	[ɐbsʊrˈdɪzm]
абсурди́ст	absurdýst	[ɐbsʊrˈdɪst]
абсурди́стка	absurdýstka	[ɐbsʊrˈdɪstkɐ]
абсу́рдність	absúrdnistʹ	[ɐˈbsurdʲnʲisʲtʲ]
абсце́с	abscés	[ɐˈbst͡sɛs]
абсци́са	abscýsa	[ɐˈbst͡sɪsɐ]
абу́зус	abúzus	[ɐˈbuzʊs]
абулі́я	abulíja	[ɐbʊˈlʲijɐ]
абха́з	abxáz	[ɐˈbxɑz]
абха́зець	abxázecʹ	[ɐˈbxɑzet͡sʲ]
абха́зка	abxázka	[ɐˈbxɑzkɐ]
абши́т	abšýt	[ɐˈbʃɪt]
авіє́тка	avijétka	[ɐu̯ʲiˈjɛtkɐ]
авіа-	aviácija	[ɐˈu̯ʲiɐ]
авіабіле́т	aviabilét	[ɐu̯ʲiɐbʲiˈlɛt]
авіаба́за	aviabáza	[ɐu̯ʲiɐˈbɑzɐ]
авіабензи́н	aviabenzýn	[ɐu̯ʲiɐbenˈzɪn]
авіабо́мба	aviabómba	[ɐu̯ʲiɐˈbɔmbɐ]
авіабудівни́к	aviabudivnýk	[ɐu̯ʲiɐbʊdʲiu̯ˈnɪk]
авіабудівни́цтво	aviabudivnýctvo	[ɐu̯ʲiɐbʊdʲiu̯ˈnɪt͡stwɔ]
авіабудува́ння	aviabuduvánnja	[ɐu̯ʲiɐbʊdʊˈu̯ɑnʲːɐ]
авіавда́р	aviavdár	[ɐu̯ʲiɐu̯ˈdɑr]
авіави́ставка	aviavýstavka	[ɐu̯ʲiɐˈu̯ɪstɐu̯kɐ]
авіагарма́та	aviaharmáta	[ɐu̯ʲiɐɦɐrˈmɑtɐ]
авіагоризо́нт	aviahoryzónt	[ɐu̯ʲiɐɦɔreˈzɔnt]
авіагоспода́рство	aviahospodárstvo	[ɐu̯ʲiɐɦɔspɔˈdɑrstwɔ]
авіадвигу́н	aviadvyhún	[ɐu̯ʲiɐdʋeˈɦun]
авіадеса́нт	aviadesánt	[ɐu̯ʲiɐdeˈsɑnt]
авіадеса́нтник	aviadesántnyk	[ɐu̯ʲiɐdeˈsɑntnek]
авіадесантува́ння	aviadesantuvánnja	[ɐu̯ʲiɐdesɐntʊˈu̯ɑnʲːɐ]
авіадиві́зія	aviadyvízija	[ɐu̯ʲiɐdeˈu̯ʲizʲijɐ]
авіадиспе́тчер	aviadyspétčer	[ɐu̯ʲiɐdeˈspɛt͡ʃːer]
авіаекспре́с	aviaeksprés	[ɐu̯ʲiɐeˈksprɛs]
авіаескадри́лья	aviaeskadrýlʹja	[ɐu̯ʲiɐeskɐˈdrɪlʲjɐ]
авіаз'є́днання	aviazʺjédnannja	[ɐu̯ʲiɐˈzjɛdnɐnʲːɐ]
авіазаво́д	aviazavód	[ɐu̯ʲiɐzɐˈu̯ɔd]
авіазагі́н	aviazahín	[ɐu̯ʲiɐzɐˈɦʲin]
авіаза́сіб	aviazásib	[ɐu̯ʲiɐˈzɑsʲib]
авіазв'язо́к	aviazvʺjazók	[ɐu̯ʲiɐzʋjɐˈzɔk]
авіака́са	aviakása	[ɐu̯ʲiɐˈkɑsɐ]
авіакатастро́фа	aviakatastrófa	[ɐu̯ʲiɐkɐtɐˈstrɔfɐ]
авіаквито́к	aviakvytók	[ɐu̯ʲiɐkʋeˈtɔk]
авіаклу́б	aviaklúb	[ɐu̯ʲiɐˈklub]
авіако́ледж	aviakóledž	[ɐu̯ʲiɐˈkɔled͡ʒ]
авіакомпа́нія	aviakompánija	[ɐu̯ʲiɐkɔmˈpɑnʲijɐ]
авіако́мплекс	aviakómpleks	[ɐu̯ʲiɐˈkɔmpleks]
авіаконстру́ктор	aviakonstrúktor	[ɐu̯ʲiɐkonˈstruktɔr]
авіаконструюва́ння	aviakonstrujuvánnja	[ɐu̯ʲiɐkɔnstrʊjʊˈu̯ɑnʲːɐ]
авіалі́нія	avialínija	[ɐu̯ʲiɐˈlʲinʲijɐ]
авіала́йнер	avialájner	[ɐu̯ʲiɐˈlɑi̯ner]
авіа́ль	aviálʹ	[ɐu̯ʲiˈɑlʲ]
авіамайсте́рня	aviamajstérnja	[ɐu̯ʲiɐmɐi̯ˈstɛrnʲɐ]
авіама́тка	aviamátka	[ɐu̯ʲiɐˈmɑtkɐ]
авіамая́к	aviamaják	[ɐu̯ʲiɐmɐˈjɑk]
авіаметеослу́жба	aviameteoslúžba	[ɐu̯ʲiɐmeteoˈsluʒbɐ]
авіаметеоста́нція	aviameteostáncija	[ɐu̯ʲiɐmeteɔˈstɑnʲt͡sʲijɐ]
зи́мородок	zýmorodok	[ˈzɪmɔrɔdɔk]
леле́ка	leléka	[leˈlɛkɐ]
Львів	Lʹviv	[lʲˈʋʲiu̯]
кия́нин	kyjányn	[keˈjɑnen]
кна́йпа	knájpa	[ˈknɑi̯pɐ]
число́	čysló	[t͡ʃeˈslɔ]
лише́	lyšé	[leˈʃɛ]
глід	hlid	[ˈɦlʲid]
берескле́т	bruslýna	[bereˈsklɛt]
	porá róku	[seˈzɔn]
ка́федра	káfedra	[ˈkɑfedrɐ]
ва́ше	váše	[ˈʋɑʃe]
украї́нець	ukrajínecʹ	[ʊkrɐˈjinet͡sʲ]
Я́ків	Jákiv	/ˈjɑkiu̯/
вона́	voná	[wɔˈnɑ]
воно́	vonó	[wɔˈnɔ]
вони́	voný	[wɔˈnɪ]
горі́лки	horílky	/ɦoˈrilkɪ/
англі́йський	Ánhlija	[ɐnˈɦlʲii̯sʲkei̯]
депута́т	deputát	[depʊˈtɑt]
авіамеха́нік	aviamexánik	[ɐu̯ʲiɐmeˈxɑnʲik]
авіамоделі́зм	aviamodelízm	[ɐu̯ʲiɐmɔdeˈlʲizm]
авіамоделі́ст	aviamodelíst	[ɐu̯ʲiɐmɔdeˈlʲist]
авіамоде́ль	aviamodélʹ	[ɐu̯ʲiɐmɔˈdɛlʲ]
авіамото́р	aviamotór	[ɐu̯ʲiɐmɔˈtɔr]
авіамоторобудува́ння	aviamotorobuduvánnja	[ɐu̯ʲiɐmɔtɔrɔbʊdʊˈu̯ɑnʲːɐ]
авіано́сець	avianósecʹ	[ɐu̯ʲiɐˈnɔset͡sʲ]
авіаобпри́скування	aviaobprýskuvannja	[ɐu̯ʲiɐɔˈbprɪskʊu̯ɐnʲːɐ]
авіаобпри́скувач	aviaobprýskuvač	[ɐu̯ʲiɐɔˈbprɪskʊu̯ɐt͡ʃ]
авіаобро́бка	aviaobróbka	[ɐu̯ʲiɐɔˈbrɔbkɐ]
авіапіджи́влення	aviapidžývlennja	[ɐu̯ʲiɐpʲiˈd͡ʒɪu̯lenʲːɐ]
авіапідприє́мство	aviapidpryjémstvo	[ɐu̯ʲiɐpʲidpreˈjɛmstwɔ]
авіапа́рк	aviapárk	[ɐu̯ʲiɐˈpɑrk]
авіапасажи́р	aviapasažýr	[ɐu̯ʲiɐpɐsɐˈʒɪr]
авіапатру́ль	aviapatrúlʹ	[ɐu̯ʲiɐpɐˈtrulʲ]
авіапатрулюва́ння	aviapatruljuvánnja	[ɐu̯ʲiɐpɐtrʊlʲʊˈu̯ɑnʲːɐ]
авіапереві́зник	aviaperevíznyk	[ɐu̯ʲiɐpereˈu̯ʲiznek]
авіапереве́зення	aviaperevézennja	[ɐu̯ʲiɐpereˈu̯ɛzenʲːɐ]
авіаперелі́т	aviaperelít	[ɐu̯ʲiɐpereˈlʲit]
авіапо́дорож	aviapódorož	[ɐu̯ʲiɐˈpɔdɔrɔʒ]
авіаполі́т	aviapolít	[ɐu̯ʲiɐpoˈlʲit]
авіапо́лк	aviapólk	[ɐu̯ʲiɐˈpɔlk]
авіапо́рт	aviapórt	[ɐu̯ʲiɐˈpɔrt]
авіапо́шта	aviapóšta	[ɐu̯ʲiɐˈpɔʃtɐ]
авіапромисло́вість	aviapromyslóvistʹ	[ɐu̯ʲiɐprɔmeˈslɔu̯ʲisʲtʲ]
авіаракетобудува́ння	aviaraketobuduvánnja	[ɐu̯ʲiɐrɐketɔbʊdʊˈu̯ɑnʲːɐ]
авіаре́йд	aviaréjd	[ɐu̯ʲiɐˈrɛi̯d]
авіаре́йс	aviaréjs	[ɐu̯ʲiɐˈrɛi̯s]
авіаро́звідка	aviarózvidka	[ɐu̯ʲiɐˈrɔzʲʋʲidkɐ]
авіарозві́дування	aviarozvíduvannja	[ɐu̯ʲiɐrɔˈzʲʋʲidʊu̯ɐnʲːɐ]
авіасало́н	aviasalón	[ɐu̯ʲiɐsɐˈlɔn]
авіасекста́нт	aviasekstánt	[ɐu̯ʲiɐseˈkstɑnt]
авіасе́рвіс	aviasérvis	[ɐu̯ʲiɐˈsɛrʋʲis]
авіасполу́чення	aviaspolúčennja	[ɐu̯ʲiɐspoˈlut͡ʃenʲːɐ]
авіаспо́рт	aviaspórt	[ɐu̯ʲiɐˈspɔrt]
авіате́хнік	aviatéxnik	[ɐu̯ʲiɐˈtɛxnʲik]
авіате́хніка	aviatéxnika	[ɐu̯ʲiɐˈtɛxnʲikɐ]
авіа́тика	aviátyka	[ɐu̯ʲiˈɑtekɐ]
авіа́тор	aviátor	[ɐu̯ʲiˈɑtɔr]
авіаторпе́да	aviatorpéda	[ɐu̯ʲiɐtɔrˈpɛdɐ]
авіатра́вма	aviatrávma	[ɐu̯ʲiɐˈtrɑu̯mɐ]
авіатра́нспорт	aviatránsport	[ɐu̯ʲiɐˈtrɑnspɔrt]
авіатра́са	aviatrása	[ɐu̯ʲiɐˈtrɑsɐ]
авіауда́р	aviaudár	[ɐu̯ʲiɐʊˈdɑr]
авіаучи́лище	aviaučýlyšče	[ɐu̯ʲiɐʊˈt͡ʃɪleʃt͡ʃe]
авіафа́уна	aviafáuna	[ɐu̯ʲiɐˈfɑʊnɐ]
авіафахіве́ць	aviafaxivécʹ	[ɐu̯ʲiɐfɐxʲiˈu̯ɛt͡sʲ]
авіахі́м	aviaxím	[ɐu̯ʲiɐˈxʲim]
авіахі́мовець	aviaxímovecʹ	[ɐu̯ʲiɐˈxʲimɔu̯et͡sʲ]
авіаці́йник	aviacíjnyk	[ɐu̯ʲiɐˈt͡sʲii̯nek]
авіа́ція	aviácija	[ɐu̯ʲiˈɑt͡sʲijɐ]
авіачасти́на	aviačastýna	[ɐu̯ʲiɐt͡ʃɐˈstɪnɐ]
авіашко́ла	aviaškóla	[ɐu̯ʲiɐˈʃkɔlɐ]
авіашо́у	aviašóu	[ɐu̯ʲiɐˈʃɔʊ]
аві́з	avíz	[ɐˈu̯ʲiz]
аві́зо	avízo	[ɐˈu̯ʲizɔ]
авізува́ння	avizuvánnja	[ɐu̯ʲizʊˈu̯ɑnʲːɐ]
аві́ста	avísta	[ɐˈu̯ʲistɐ]
авітаміно́з	avitaminóz	[ɐu̯ʲitɐmʲiˈnɔz]
авіфа́уна	avifáuna	[ɐu̯ʲiˈfɑʊnɐ]
авалі́ст	avalíst	[ɐu̯ɐˈlʲist]
ава́ль	aválʹ	[ɐˈu̯ɑlʲ]
аванга́рд	avanhárd	[ɐu̯ɐnˈɦɑrd]
авангарди́зм	avanhardýzm	[ɐu̯ɐnɦɐrˈdɪzm]
авангарди́ст	avanhardýst	[ɐu̯ɐnɦɐrˈdɪst]
аванза́л	avanzál	[ɐu̯ɐnˈzɑl]
аванка́мера	avankámera	[ɐu̯ɐnˈkɑmerɐ]
аванло́жа	avanlóža	[ɐu̯ɐnˈlɔʒɐ]
аванпо́рт	avanpórt	[ɐu̯ɐˈnpɔrt]
аванпо́ст	avanpóst	[ɐu̯ɐˈnpɔst]
ава́нс	aváns	[ɐˈu̯ɑns]
ава́нсик	avánsyk	[ɐˈu̯ɑnsek]
авансода́вець	avansodávecʹ	[ɐu̯ɐnsɔˈdɑu̯et͡sʲ]
авансотрима́ч	avansotrymáč	[ɐu̯ɐnsɔtreˈmɑt͡ʃ]
авансоутри́мувач	avansoutrýmuvač	[ɐu̯ɐnsɔʊˈtrɪmʊu̯ɐt͡ʃ]
авансува́ння	avansuvánnja	[ɐu̯ɐnsʊˈu̯ɑnʲːɐ]
авансце́на	avanscéna	[ɐu̯ɐnˈst͡sɛnɐ]
аванти́тул	avantýtul	[ɐu̯ɐnˈtɪtʊl]
аванту́ра	avantúra	[ɐu̯ɐnˈturɐ]
аванту́рник	avantúrnyk	[ɐu̯ɐnˈturnek]
аванту́рниця	avantúrnycja	[ɐu̯ɐnˈturnet͡sʲɐ]
авантю́ра	avantjúra	[ɐu̯ɐnʲˈtʲurɐ]
авантюри́зм	avantjurýzm	[ɐu̯ɐnʲtʲʊˈrɪzm]
авантюри́н	avantjurýn	[ɐu̯ɐnʲtʲʊˈrɪn]
авантюри́ст	avantjurýst	[ɐu̯ɐnʲtʲʊˈrɪst]
авантюри́стка	avantjurýstka	[ɐu̯ɐnʲtʲʊˈrɪstkɐ]
авантю́рність	avantjúrnistʹ	[ɐu̯ɐnʲˈtʲurnʲisʲtʲ]
авантю́рник	avantjúrnyk	[ɐu̯ɐnʲˈtʲurnek]
авантю́рниця	avantjúrnycja	[ɐu̯ɐnʲˈtʲurnet͡sʲɐ]
ава́р	avár	[ɐˈu̯ɑr]
аварі́йність	avaríjnistʹ	[ɐu̯ɐˈrʲii̯nʲisʲtʲ]
аварі́йник	avaríjnyk	[ɐu̯ɐˈrʲii̯nek]
ава́рія	avárija	[ɐˈu̯ɑrʲijɐ]
ава́рець	avárecʹ	[ɐˈu̯ɑret͡sʲ]
ава́рка	avárka	[ɐˈu̯ɑrkɐ]
авгі́т	avhít	[ɐu̯ˈɦʲit]
авгу́р	avhúr	[ɐu̯ˈɦur]
а́вгуст	ávhust	[ˈɑu̯ɦʊst]
Авгу́ста	Avhústa	[ɐu̯ˈɦustɐ]
авди́тор	avdýtor	[ɐu̯ˈdɪtɔr]
авдито́рія	avdytórija	[ɐu̯deˈtɔrʲijɐ]
авеню́	avenjú	[ɐu̯eˈnʲu]
а́верс	ávers	[ˈɑu̯ers]
авло́с	avlós	[ɐu̯ˈlɔs]
а́во	ávo	[ˈɑu̯ɔ]
авока́до	avokádo	[ɐu̯ɔˈkɑdɔ]
авра́л	avrál	[ɐu̯ˈrɑl]
авра́н	avrán	[ɐu̯ˈrɑn]
аври́кула	avrýkula	[ɐu̯ˈrɪkʊlɐ]
авро́ра	avróra	[ɐu̯ˈrɔrɐ]
австрі́єць	avstríjecʹ	[ɐu̯ˈstʲrʲijet͡sʲ]
австрі́йка	avstríjka	[ɐu̯ˈstʲrʲii̯kɐ]
австрія́к	avstriják	[ɐu̯stʲrʲiˈjɑk]
австрія́чка	avstrijáčka	[ɐu̯stʲrʲiˈjɑt͡ʃkɐ]
австралі́єць	avstralíjecʹ	[ɐu̯strɐˈlʲijet͡sʲ]
австралі́йка	avstralíjka	[ɐu̯strɐˈlʲii̯kɐ]
австрало́їд	avstralójid	[ɐu̯strɐˈlɔjid]
австралопіте́к	avstralopiték	[ɐu̯strɐlɔpʲiˈtɛk]
австромаркси́ст	avstromarksýst	[ɐu̯strɔmɐrˈksɪst]
австрофі́л	avstrofíl	[ɐu̯stroˈfʲil]
автаркі́зм	avtarkízm	[ɐu̯tɐrˈkʲizm]
авта́ркія	avtárkija	[ɐu̯ˈtɑrkʲijɐ]
авте́нтика	avténtyka	[ɐu̯ˈtɛntekɐ]
автентифіка́ція	avtentyfikácija	[ɐu̯tentefʲiˈkɑt͡sʲijɐ]
автенти́чність	avtentýčnistʹ	[ɐu̯tenˈtɪt͡ʃnʲisʲtʲ]
авто́	avtó	[ɐu̯ˈtɔ]
автоаерозапчасти́на	avtoaerozapčastýna	[ɐu̯tɔɐerɔzɐpt͡ʃɐˈstɪnɐ]
автоалієна́ція	avtoalijenácija	[ɐu̯tɔɐlʲijeˈnɑt͡sʲijɐ]
автоама́тор	avtoamátor	[ɐu̯tɔɐˈmɑtɔr]
автоама́торка	avtoamátorka	[ɐu̯tɔɐˈmɑtɔrkɐ]
автоамфі́бія	avtoamfíbija	[ɐu̯tɔɐmˈfʲibʲijɐ]
автоаполо́гія	avtoapolóhija	[ɐu̯tɔɐpɔˈlɔɦʲijɐ]
автобіо́граф	avtobióhraf	[ɐu̯tɔbʲiˈɔɦrɐf]
автобіографі́чність	avtobiohrafíčnistʹ	[ɐu̯tɔbʲiɔɦrɐˈfʲit͡ʃnʲisʲtʲ]
автобіогра́фія	avtobiohráfija	[ɐu̯tɔbʲiɔˈɦrɑfʲijɐ]
автоба́за	avtobáza	[ɐu̯tɔˈbɑzɐ]
автобальза́м	avtobalʹzám	[ɐu̯tɔbɐlʲˈzɑm]
автоба́н	avtobán	[ɐu̯tɔˈbɑn]
автобатальйо́н	avtobatalʹjón	[ɐu̯tɔbɐtɐˈlʲjɔn]
автобензово́з	avtobenzovóz	[ɐu̯tɔbenzɔˈu̯ɔz]
автобензоцисте́рна	avtobenzocystérna	[ɐu̯tɔbenzɔt͡seˈstɛrnɐ]
автобетономіша́лка	avtobetonomišálka	[ɐu̯tɔbetɔnɔmʲiˈʃɑlkɐ]
автоблокува́ння	avtoblokuvánnja	[ɐu̯tɔblɔkʊˈu̯ɑnʲːɐ]
автобудівни́к	avtobudivnýk	[ɐu̯tɔbʊdʲiu̯ˈnɪk]
автобудува́ння	avtobuduvánnja	[ɐu̯tɔbʊdʊˈu̯ɑnʲːɐ]
авто́бус	avtóbus	[ɐu̯ˈtɔbʊs]
авто́бусик	avtóbus	[ɐu̯ˈtɔbʊsek]
автовідповіда́ч	avtovidpovidáč	[ɐu̯tɔu̯ʲidpɔu̯ʲiˈdɑt͡ʃ]
автовізо́к	avtovizók	[ɐu̯tɔu̯ʲiˈzɔk]
автовага́	avtovahá	[ɐu̯tɔu̯ɐˈɦɑ]
автоваго́н	avtovahón	[ɐu̯tɔu̯ɐˈɦɔn]
автовакци́на	avtovakcýna	[ɐu̯tɔu̯ɐˈkt͡sɪnɐ]
автованта́жник	avtovantážnyk	[ɐu̯tɔu̯ɐnˈtɑʒnek]
автовеломотого́нки	avtovelomotohónky	[ɐu̯tɔu̯elɔmɔtɔˈɦɔnke]
автовиробни́к	avtovyrobnýk	[ɐu̯tɔu̯erɔˈbnɪk]
автовла́сник	avtovlásnyk	[ɐu̯tɔu̯ˈlɑsnek]
автоводі́й	avtovodíj	[ɐu̯tɔu̯oˈdʲii̯]
автоводоцисте́рна	avtovodocystérna	[ɐu̯tɔu̯ɔdɔt͡seˈstɛrnɐ]
автовокза́л	avtovokzál	[ɐu̯tɔu̯ɔˈɡzɑl]
автогальмо́	avtohalʹmó	[ɐu̯tɔɦɐlʲˈmɔ]
автогара́ж	avtoharáž	[ɐu̯tɔɦɐˈrɑʒ]
автогемотерапі́я	avtohemoterapíja	[ɐu̯tɔɦemɔterɐˈpʲijɐ]
автоге́н	avtohén	[ɐu̯tɔˈɦɛn]
автогене́з	avtohenéz	[ɐu̯tɔɦeˈnɛz]
автоге́нник	avtohénnyk	[ɐu̯tɔˈɦɛnːek]
автомобі́ль	avtomobílʹ	[ɐu̯tɔmoˈbʲilʲ]
а́втор	ávtor	[ˈɑu̯tɔr]
ага́ва	aháva	[ɐˈɦɑu̯ɐ]
ад'юта́нт	adʺjutánt	[ɐdjʊˈtɑnt]
адміністра́ція	administrácija	[ɐdʲmʲinʲiˈstrɑt͡sʲijɐ]
аеродро́м	aerodróm	[ɐerɔˈdrɔm]
аеролі́т	aerolít	[ɐeroˈlʲit]
аеропо́рт	aeropórt	[ɐerɔˈpɔrt]
а́збука	jazʺbuka	[ˈɑzbʊkɐ]
акаде́мія	akadémija	[ɐkɐˈdɛmʲijɐ]
ака́ція	akácija	[ɐˈkɑt͡sʲijɐ]
аква́ріум	akvárium	[ɐˈkʋɑrʲiʊm]
акт	akt	[ˈɑkt]
аку́ла	akúla	[ɐˈkulɐ]
а́кція	ákcija	[ˈɑkt͡sʲijɐ]
але́	alé	[ɐˈlɛ]
алфа́ві́т	alfavytʺ	[ɐlfɐˈu̯ʲit]
альбатро́с	alʹbatrós	[ɐlʲbɐˈtrɔs]
альфабе́т	alfabet	[ɐlʲfɐˈbɛt]
Аме́рика	Améryka	[ɐˈmɛrekɐ]
американіза́ція	amerykanizácija	[ɐmerekɐnʲiˈzɑt͡sʲijɐ]
американі́зм	amerykanízm	[ɐmerekɐˈnʲizm]
америка́нець	amerykánecʹ	[ɐmereˈkɑnet͡sʲ]
америка́нка	amerykánka	[ɐmereˈkɑnkɐ]
америка́нський	amerykánsʹkyj	[ɐmereˈkɑnʲsʲkei̯]
ана́ліз	análiz	[ɐˈnɑlʲiz]
Анастасі́я	Anastasíja	[ɐnɐstɐˈsʲijɐ]
Ангелі́на	Anhelína	[ɐnɦeˈlʲinɐ]
англі́єць	anhlíjecʹ	[ɐnˈɦlʲijet͡sʲ]
англі́йка	anhlíjka	[ɐnˈɦlʲii̯kɐ]
англі́йський	Ánhlija	[ɐnˈɦlʲii̯sʲkei̯]
англіка́нство	anhlikánstvo	[ɐnɦlʲiˈkɑnstwɔ]
англіци́зм	anhlicýzm	[ɐnɦlʲiˈt͡sɪzm]
А́нглія	Ánhlija	[ˈɑnɦlʲijɐ]
анекдо́т	anekdót	[ɐneˈɡdɔt]
зи́мородок	zýmorodok	[ˈzɪmɔrɔdɔk]
леле́ка	leléka	[leˈlɛkɐ]
Львів	Lʹviv	[lʲˈʋʲiu̯]
кия́нин	kyjányn	[keˈjɑnen]
кна́йпа	knájpa	[ˈknɑi̯pɐ]
число́	čysló	[t͡ʃeˈslɔ]
лише́	lyšé	[leˈʃɛ]
глід	hlid	[ˈɦlʲid]
берескле́т	bruslýna	[bereˈsklɛt]
	porá róku	[seˈzɔn]
ка́федра	káfedra	[ˈkɑfedrɐ]
ва́ше	váše	[ˈʋɑʃe]
украї́нець	ukrajínecʹ	[ʊkrɐˈjinet͡sʲ]
Я́ків	Jákiv	/ˈjɑkiu̯/
вона́	voná	[wɔˈnɑ]
воно́	vonó	[wɔˈnɔ]
вони́	voný	[wɔˈnɪ]
горі́лки	horílky	/ɦoˈrilkɪ/
англі́йський	Ánhlija	[ɐnˈɦlʲii̯sʲkei̯]
депута́т	deputát	[depʊˈtɑt]
А́нна	Ánna	[ˈɑnːɐ]
антаркти́чний	antarktýčnyj	[ɐntɐrˈktɪt͡ʃnei̯]
апо́стро́ф	apóstróf	[ɐˈpɔstrɔf]
аркти́чний	arktýčnyj	[ɐrˈktɪt͡ʃnei̯]
а́рмія	ármija	[ˈɑrmʲijɐ]
арфі́ст	arfíst	[ɐrˈfʲist]
арфі́стка	arfístka	[ɐrˈfʲistkɐ]
а́рфа	árfa	[ˈɑrfɐ]
Арфу́ш	Arfúš	[ɐrˈfuʃ]
архаїза́ція	arxajizácija	[ɐrxɐjiˈzɑt͡sʲijɐ]
архаї́зм	arxajízm	[ɐrxɐˈjizm]
архо́нт	arxónt	[ɐrˈxɔnt]
Асі́я	Asíja	[ɐˈsʲijɐ]
асиміля́ція	asymiljácija	[ɐsemʲiˈlʲɑt͡sʲijɐ]
асимпто́та	asymptóta	[ɐsemˈptɔtɐ]
асисте́нт	asystént	[ɐseˈstɛnt]
асисте́нтка	asysténtka	[ɐseˈstɛntkɐ]
асоціа́ція	asociácija	[ɐsɔt͡sʲiˈɑt͡sʲijɐ]
атланти́чний	atlantýčnyj	[ɐtlɐnˈtɪt͡ʃnei̯]
а́ґрус	ágrus	[ˈɑɡrʊs]
аґрусі́вка	agrusívka	[ɐɡrʊˈsʲiu̯kɐ]
бібліома́нія	bibliománija	[bʲiblʲiɔˈmɑnʲijɐ]
бібліоте́кар	bibliotékar	[bʲiblʲiɔˈtɛkɐr]
бібліоте́карка	bibliotékarka	[bʲiblʲiɔˈtɛkɐrkɐ]
бібліофі́л	bibliofíl	[bʲiblʲioˈfʲil]
Бі́блія	Bíblija	[ˈbʲiblʲijɐ]
бік	bik	[ˈbʲik]
Білору́сь	Bilorúsʹ	[bʲiloˈrusʲ]
біоло́гія	biolóhija	[bʲiɔˈlɔɦʲijɐ]
біомеха́ніка	biomexánika	[bʲiɔmeˈxɑnʲikɐ]
біомоле́кула	bio-	[bʲiɔmɔˈlɛkʊlɐ]
бірюзо́вий	birjuzóvyj	[bʲirʲʊˈzɔu̯ei̯]
бабу́ся	bába	[bɐˈbusʲɐ]
бага́то	baháto	[bɐˈɦɑtɔ]
багатоповерхо́вий	bahatopoverxóvyj	[bɐɦɐtɔpɔu̯erˈxɔu̯ei̯]
багряний	bahrjanyj	[bɐɦrʲɐnei̯]
бажа́ння	bažánnja	[bɐˈʒɑnʲːɐ]
ба́за	báza	[ˈbɑzɐ]
байт	bajt	[ˈbɑi̯t]
баклажа́н	baklažán	[bɐklɐˈʒɑn]
балко́н	balkón	[bɐlˈkɔn]
банк	bank	[ˈbɑnk]
банкно́та	banknóta	[bɐnˈknɔtɐ]
ба́ня	bánja	[ˈbɑnʲɐ]
бара́н	barán	[bɐˈrɑn]
ба́рва	bárva	[ˈbɑrʋɐ]
баскетбо́л	basketból	[bɐskeˈdbɔl]
ба́тьківщи́на	bátʹkivščýna	[ˈbɑtʲkʲiu̯ˈʃt͡ʃɪnɐ]
ба́тько	bátʹo	[ˈbɑtʲkɔ]
ба́чити	báčyty	[ˈbɑt͡ʃete]
бджі́лка	bdžílka	[ˈbd͡ʒʲilkɐ]
бджільни́цтво	bdžilʹnýctvo	[bd͡ʒʲilʲˈnɪt͡stwɔ]
безглуздий	bezhluzdyj	[beˈzɦluzdei̯]
бездога́нно	bezdohánno	/bɛzdoˈɦɑnːo/
безпе́ка	bezpéka	[beˈzpɛkɐ]
бе́резень	bérezenʹ	[ˈbɛrezenʲ]
бере́зовий	beréz-	[beˈrɛzɔu̯ei̯]
берескле́т	bruslýna	[bereˈsklɛt]
бе́сіда	bésida	[ˈbɛsʲidɐ]
бик	byk	[ˈbɪk]
битв	bytv	[ˈbɪtʋ]
би́твами	býtvamy	[ˈbɪtʋɐme]
би́твах	býtvax	[ˈbɪtʋɐx]
би́тво	býtvo	[ˈbɪtwɔ]
блакитний	blakytnyj	[blɐˈkɪtnei̯]
бог	boh	[ˈbɔɦ]
Богда́н	Bohdán	/boɣˈdɑn/
Бори́с	Borísʺ	[bɔˈrɪs, ˈbɔres]
боротьба́	borotʹbá	[bɔrɔˈdʲbɑ]
бо́рошно	bórošno	[ˈbɔrɔʃnɔ]
борщ	boršč	[ˈbɔrʃt͡ʃ]
брат	brat	[ˈbrɑt]
бра́ти	bráty	[ˈbrɑte]
Братисла́ва	Bratysláva	[brɐteˈslɑu̯ɐ]
бреха́ти	brexáty	[breˈxɑte]
бридки́й	brydkýj	[breˈdkɪi̯]
брусни́ця	brusnýcja	[brʊˈsnɪt͡sʲɐ]
бу́бна	búbna	[ˈbubnɐ]
буга́й	buháj	[bʊˈɦɑi̯]
будівни́цтво	budivnýctvo	[bʊdʲiu̯ˈnɪt͡stwɔ]
Бу́дда	Búdda	[ˈbudːɐ]
буди́нок	buda	[bʊˈdɪnɔk]
будь ла́ска	budʹ láska	[bʊdʲ ˈlɑskɐ]
будь-хто	bud'-xtó	/budʲˈxtɔ/
будя́к	budják	[bʊˈdʲɑk]
бузина́	buz	[bʊzeˈnɑ]
бу́ква	búkva	[ˈbukʋɐ]
була́	bulá	[bʊˈlɑ]
бу́льба	búlʹba	[ˈbulʲbɐ]
буря́к	burják	[bʊˈrʲɑk]
бюдже́т	bjudžét	[bʲʊˈd͡ʒɛt]
бюро́	bjuró	[bʲʊˈrɔ]
в тому числі	v tómu čyslí	/fˈtɔmu t͡ʃɪsˈli/
в'я́зи	vʺjázy	[ˈʋjɑze]
віве́ра	vivéra	[ʋʲiˈu̯ɛrɐ]
відмі́на	vidmína	[ʋʲiˈdʲmʲinɐ]
відмі́нювання	vidmínjuvannja	[ʋʲiˈdʲmʲinʲʊu̯ɐnʲːɐ]
віднести́	vid-	[ʋʲidneˈstɪ]
відно́сини	vidnósyny	[ʋʲiˈdnɔsene]
відповіда́льність	vidpovidaty	[ʋʲidpɔu̯ʲiˈdɑlʲnʲisʲtʲ]
ві́дповідь	vídpovidʹ	[ˈʋʲidpɔu̯ʲidʲ]
відсо́ток	vidsótok	[ʋʲiˈd͡zsɔtɔk]
відсу́тність	vidsútnistʹ	[ʋʲiˈd͡zsutʲnʲisʲtʲ]
віз	viz	[ˈʋʲiz]
війна́	vijná	[ʋʲii̯ˈnɑ]
ві́йсько	víjsʹko	[ˈʋʲii̯sʲkɔ]
Вікно́	Viknó	[ʋʲiˈknɔ]
віко́нце	vikónce	[ʋʲiˈkɔnt͡se]
він	vin	[ˈʋʲin]
ві́но	víno	[ˈʋʲinɔ]
Ві́ра	Víra	[ˈʋʲirɐ]
віск	visk	[ˈʋʲisk]
ві́тер	víter	[ˈʋʲiter]
ві́тка	vítka	[ˈʋʲitkɐ]
ві́я	víja	[ˈʋʲijɐ]
вагі́тна	vahítna	[ʋɐˈɦʲitnɐ]
вагі́тний	vaha	[ʋɐˈɦʲitnei̯]
важки́й	važkýj	[ʋɐˈʒkɪi̯]
ва́нна	vánna	[ˈʋɑnːɐ]
вантажі́вка	vantažívka	[ʋɐntɐˈʒʲiu̯kɐ]
ва́ртість	vártistʹ	[ˈʋɑrtʲisʲtʲ]
ва́тра	vátra	[ˈʋɑtrɐ]
ваш	vaš	[ˈʋɑʃ]
ва́ша	váša	[ˈʋɑʃɐ]
ва́ше	váše	[ˈʋɑʃe]
вдова́	vdová	[wdɔˈu̯ɑ]
ведмі́дь	vedmídʹ	[ʋedmʲˈidʲ]
ве́жа	véža	[ˈʋɛʒɐ]
везти́	veztý	[ʋeˈztɪ]
вели́кий	velýkyj	[ʋeˈlɪkei̯]
велосипе́д	velosypéd	[ʋelɔseˈpɛd]
велосипеди́ст	velosypedýst	[ʋelɔsepeˈdɪst]
велосипеди́стка	velosypedýstka	[ʋelɔsepeˈdɪstkɐ]
велоспо́рт	velospórt	[ʋelɔˈspɔrt]
ве́на	véna	[ˈʋɛnɐ]
ве́рес	véres	[ˈʋɛres]
ве́ресень	veres	[ˈʋɛresenʲ]
Вероні́ка	Veroníka	[ʋeroˈnʲikɐ]
вертолі́т	vertolít	[ʋertoˈlʲit]
верф	verf	[ˈʋɛrf]
весна́	vesná	[ʋeˈsnɑ]
весняни́й	vesnjanýj	[ʋesʲnʲɐˈnɪi̯]
		[ʋeˈstɪ]
ве́чір	véčir	[ˈʋɛt͡ʃʲir]
ви	vy	[ˈʋɪ]
ви́бір	výbir	[ˈʋɪbʲir]
ви́борець	výborecʹ	[ˈʋɪbɔret͡sʲ]
ви́бори	výbory	[ˈʋɪbɔre]
зи́мородок	zýmorodok	[ˈzɪmɔrɔdɔk]
леле́ка	leléka	[leˈlɛkɐ]
Львів	Lʹviv	[lʲˈʋʲiu̯]
кия́нин	kyjányn	[keˈjɑnen]
кна́йпа	knájpa	[ˈknɑi̯pɐ]
число́	čysló	[t͡ʃeˈslɔ]
лише́	lyšé	[leˈʃɛ]
глід	hlid	[ˈɦlʲid]
берескле́т	bruslýna	[bereˈsklɛt]
	porá róku	[seˈzɔn]
ка́федра	káfedra	[ˈkɑfedrɐ]
ва́ше	váše	[ˈʋɑʃe]
украї́нець	ukrajínecʹ	[ʊkrɐˈjinet͡sʲ]
Я́ків	Jákiv	/ˈjɑkiu̯/
вона́	voná	[wɔˈnɑ]
воно́	vonó	[wɔˈnɔ]
вони́	voný	[wɔˈnɪ]
горі́лки	horílky	/ɦoˈrilkɪ/
англі́йський	Ánhlija	[ɐnˈɦlʲii̯sʲkei̯]
депута́т	deputát	[depʊˈtɑt]
ви́гляд	výhljad	[ˈʋɪɦlʲɐd]
ви́гук	výhuk	[ˈʋɪɦʊk]
вид	vyd	[ˈʋɪd]
вида́ння	vydánnja	[ʋeˈdɑnʲːɐ]
виде́лка	-ka	[ʋeˈdɛlkɐ]
ви́дра	výdra	[ˈʋɪdrɐ]
ви́жлоктати	výžloktaty	[ˈʋɪʒlɔktɐte]
ви́жлуктати	výžluktaty	[ˈʋɪʒlʊktɐte]
ви́жлуктити	žlukto	[ˈʋɪʒlʊktete]
ви́значення	význačennja	[ˈʋɪznɐt͡ʃenʲːɐ]
ви́клад	výklad	[ˈʋɪklɐd]
викона́ння	vykonánnja	[ʋekɔˈnɑnʲːɐ]
використа́ння	vykorystánnja	[ʋekɔreˈstɑnʲːɐ]
вимо́ва	vymóva	[ʋeˈmɔu̯ɐ]
вимо́га	vymóha	[ʋeˈmɔɦɐ]
ви́нник	výnnyk	[ˈʋɪnːek]
вино́	vynó	[ʋeˈnɔ]
виногра́д	vyno	[ʋenɔˈɦrɑd]
виногра́дник	vynohrádnyk	[ʋenɔˈɦrɑdnek]
виноку́р	vynokúr	[ʋenoˈkur]
виноку́рня	vynokúrnja	[ʋenoˈkurnʲɐ]
ви́падок	výpadok	[ˈʋɪpɐdɔk]
ви́рішення	výrišennja	[ˈʋɪrʲiʃenʲːɐ]
виробни́цтво	vyrobnýctvo	[ʋerɔˈbnɪt͡stwɔ]
ви́сновок	výsnovok	[ˈʋɪsnɔu̯ɔk]
висота́	vysotá	[ʋesɔˈtɑ]
ви́трата	výtrata	[ˈʋɪtrɐtɐ]
ви́хід	výxid	[ˈʋɪxʲid]
вла́сність	vlásnistʹ	[ˈwlɑsʲnʲisʲtʲ]
вла́сник	vlastʹ	[ˈwlɑsnek]
власти́вість	vlastývyj	/vlɑsˈtɪvistʲ/
вне́сок	vnésok	[ˈwnɛsɔk]
вовк	vovk	[ˈwɔu̯k]
во́вна	vóvna	[ˈwɔu̯nɐ]
вого́нь	vohónʹ	[wɔˈɦɔnʲ]
вода́	vodá	[wɔˈdɑ]
во́день	helij	[ˈwɔdenʲ]
вокза́л	vokzál	[wɔˈɡzɑl]
во́лос	vólos	[ˈwɔlɔs]
во́ля	vólja	[ˈwɔlʲɐ]
вона́	voná	[wɔˈnɑ]
вони́	voný	[wɔˈnɪ]
воно́	vonó	[wɔˈnɔ]
во́рон	vóron	[ˈwɔrɔn]
вплив	vplyv	[ˈʍplɪu̯]
врахо́вувати	uraxóvuvaty	[wrɐˈxɔu̯ʊu̯ɐte]
втра́та	vtráta	[ˈʍtrɑtɐ]
вуж	vuž	[ˈwuʒ]
ву́зол	vúzol	[ˈwuzɔl]
вузьки́й	vuzʹkýj	[wʊˈzʲkɪi̯]
ву́лиця	vúlycja	[ˈwulet͡sʲɐ]
		
вчи́тель	včýtelʹ	[ˈʍt͡ʃɪtelʲ]
г	h	/ɦ/
гі́лка	hílka	/ˈɦilkɑ/
газе́та	hazéta	[ɦɐˈzɛtɐ]
гал	hal	[ˈɦɑl]
Гали́на	Halýna	[ɦɐˈlɪnɐ]
га́лиця	hálycja	[ˈɦɑlet͡sʲɐ]
га́рний	harʺ	[ˈɦɑrnei̯]
га́яти	hájaty	[ˈɦɑjɐte]
геро́й	herój	[ɦeˈrɔi̯]
глід	hlid	[ˈɦlʲid]
глава́	hlavá	[ɦlɐˈu̯ɑ]
глади́лка	hládyty	[ɦlɐˈdɪlkɐ]
глибина́	hlybyná	[ɦlebeˈnɑ]
го́голь	hóholʹ	[ˈɦɔɦɔlʲ]
го́лий	hólyj	/ˈɦɔlɪj/
голова́	holová	[ɦɔlɔˈu̯ɑ]
головни́й	holová	[ɦɔlɔu̯ˈnɪi̯]
голосни́й	hólos	[ɦɔlɔˈsnɪi̯]
го́луб	hólub	[ˈɦɔlʊb]
гольф	holʹf	[ˈɦɔlʲf]
горі́лка	harílka	[ɦoˈrʲilkɐ]
горі́лки	horílky	/ɦoˈrilkɪ/
горі́х	horíx	/ ɦɔˈrix/
гора́	horá	[ɦɔˈrɑ]
		[ˈɦɔrn]
горох	horox	[ɦɔˈrɔx]
господа́рство	hospodar	[ɦɔspɔˈdɑrstwɔ]
гріх	hrix	/ɦrix/
грана́та	hranáta	[ɦrɐˈnɑtɐ]
гра́ти	hráty	[ˈɦrɑte]
грець	hra	[ˈɦrɛt͡sʲ]
гре́чка	hréčka	[ˈɦrɛt͡ʃkɐ]
гриб	hryb	/ ɦrɪb/
грома́да	hromáda	[ɦrɔˈmɑdɐ]
гро́шей	hróšej	[ˈɦrɔʃei̯]
губа́	hubá	[ɦʊˈbɑ]
гуля́ти	hulja	[ɦʊˈlʲɑte]
Діа́на	Diána	[dʲiˈɑnɐ]
ді́вка	dívka	[ˈdʲiu̯kɐ]
дід	dído	[ˈdʲid]
діля́нка	diljánka	[dʲiˈlʲɑnkɐ]
ді́я	díja	[ˈdʲijɐ]
Дари́на	Darýna	[dɐˈrɪnɐ]
два	dva	[ˈdʋɑ]
двадцятиодноку́тник	dvadcjatyodnokútnyk	[dʋɐd͡zʲt͡sʲɐteɔdnoˈkutnek]
двана́дцять	dvanadcjatʹ	[dʋɐˈnɑd͡zʲt͡sʲɐtʲ]
де	de	[ˈdɛ]
дев'яси́л	dyvosýl	[deu̯jɐˈsɪl]
де́в'ять	devʺjatʹ	/ˈdɛu̯jɐc/
декілька	de-	[ˈdɛkʲilʲkɐ]
деклара́ція	deklarácija	[deklɐˈrɑt͡sʲijɐ]
декора́ція	dekorácija	[dekɔˈrɑt͡sʲijɐ]
демокра́тія	demokrátija	[demɔˈkrɑtʲijɐ]
день	denʹ	[ˈdɛnʲ]
депре́сія	deprésija	[deˈprɛsʲijɐ]
депута́т	deputát	[depʊˈtɑt]
дере́н	derén	[deˈrɛn]
держпо́зика	deržávna	[derˈʒpɔzekɐ]
десь	desʹ	/dɛsʲ/
джи́нси	džýnsy	[ˈd͡ʒɪnse]
дзвін	dzvin	[ˈd͡zʲʋʲin]
дзвіни́ця	dzvinýcja	/d͡zviˈnɪt͡sʲɑ/
дзво́ник	dzvónyk	[ˈd͡zwɔnek]
дзвони́ти	dzvonýty	[d͡zwɔˈnɪte]
дивина́	dyvyná	[deu̯eˈnɑ]
дим	dym	/dɪm/
дире́ктор	dyréktor	[deˈrɛktɔr]
диску́сія	dyskúsija	[deˈskusʲijɐ]
дискута́нт	dyskutánt	[deskʊˈtɑnt]
диспе́тчер	dyspétčer	[deˈspɛt͡ʃːer]
дити́на	dytýna	[deˈtɪnɐ]
для	dlja	[ˈdʲlʲɑ]
Дніпро́	Dněprʺ	[dʲnʲiˈprɔ]
добриве́чір	dóbryj véčir	[dɔbreˈu̯ɛt͡ʃʲir]
добриде́нь	dóbryj denʹ	[dɔbreˈdɛnʲ]
до́брий	dóbryj	[ˈdɔbrɪj]
до́брий ра́нок	dóbryj ránok	[ˈdɔbrej ˈrɑnɔk]
дові́дник	dovídnyk	/dovidˈnɪk/
дові́ра	dovíra	[dɔˈu̯ʲirɐ]
до́вгий	dóvhyj	[ˈdɔu̯ɦei̯]
до́гові́р	dóhovír	[ˈdɔɦɔˈu̯ʲir]
доктора́т	doktorát	/doktoˈrat/
до́лар	dólar	[ˈdɔlɐr]
доли́на	dolýna	[dɔˈlɪnɐ]
до́ля	dólja	[ˈdɔlʲɐ]
домініка́нський	dominikánsʹkyj	[dɔmʲinʲiˈkɑnʲsʲkei̯]
До́нальд Дак	Dónalʹd Dak	[ˈdɔnɐlʲd ˈdɑk]
Донба́с	Donbás	[dɔˈnbɑs]
Доне́ць	Donécʹ	[dɔˈnɛt͡sʲ]
допомо́га	dopomóha	/dopoˈmɔɦɑ/
до́свід	dósvid	[ˈdɔsʲʋʲid]
дося́гнення	dosjáhnennja	[dɔˈsʲɑɦnenʲːɐ]
дохі́д	doxíd	[doˈxʲid]
до́шка	dóška	[ˈdɔʃkɐ]
дро́ва	dróva	[drɔu̯ɐ]
друг	druh	[ˈdruɦ]
дружи́на	družýna	/druˈʐɪnɑ/
		
		
дурни́й	durnýj	[dʊrˈnɪi̯]
дя́кую	djákuju	[ˈdʲɑkʊjʊ]
екваторіа́льний	ekvatoriálʹnyj	[ekʋɐtɔrʲiˈɑlʲnei̯]
еконо́міка	ekonómika	[ekɔˈnɔmʲikɐ]
економі́чний	ekonomíčnyj	[ekɔnoˈmʲit͡ʃnei̯]
екску́рсія	ekskúrsija	[eˈkskursʲijɐ]
експеди́ціє	ekspedýcije	[ekspeˈdɪt͡sʲije]
експеди́цією	ekspedýcijeju	[ekspeˈdɪt͡sʲijejʊ]
експеди́цій	ekspedýcij	[ekspeˈdɪt͡sʲii̯]
експеди́цію	ekspedýciju	[ekspeˈdɪt͡sʲijʊ]
експеди́ція	ekspedýcija	[ekspeˈdɪt͡sʲijɐ]
експеди́ціям	ekspedýcijam	[ekspeˈdɪt͡sʲijɐm]
експеди́ціями	ekspedýcijamy	[ekspeˈdɪt͡sʲijɐme]
зи́мородок	zýmorodok	[ˈzɪmɔrɔdɔk]
леле́ка	leléka	[leˈlɛkɐ]
Львів	Lʹviv	[lʲˈʋʲiu̯]
кия́нин	kyjányn	[keˈjɑnen]
кна́йпа	knájpa	[ˈknɑi̯pɐ]
число́	čysló	[t͡ʃeˈslɔ]
лише́	lyšé	[leˈʃɛ]
глід	hlid	[ˈɦlʲid]
берескле́т	bruslýna	[bereˈsklɛt]
	porá róku	[seˈzɔn]
ка́федра	káfedra	[ˈkɑfedrɐ]
ва́ше	váše	[ˈʋɑʃe]
украї́нець	ukrajínecʹ	[ʊkrɐˈjinet͡sʲ]
Я́ків	Jákiv	/ˈjɑkiu̯/
вона́	voná	[wɔˈnɑ]
воно́	vonó	[wɔˈnɔ]
вони́	voný	[wɔˈnɪ]
горі́лки	horílky	/ɦoˈrilkɪ/
англі́йський	Ánhlija	[ɐnˈɦlʲii̯sʲkei̯]
депута́т	deputát	[depʊˈtɑt]
експеди́ціях	ekspedýcijax	[ekspeˈdɪt͡sʲijɐx]
експе́рт	ekspért	[eˈkspɛrt]
елеме́нт	elemént	[eleˈmɛnt]
жіно́чий	žinóčyj	[ʒʲiˈnɔt͡ʃei̯]
жіно́чий рід	žinóčyj rid	[ʒʲiˈnɔt͡ʃej rʲid]
жа́ло́	žáló	[ˈʒɑlɔ]
жало́ба	žalóba	[ʒɐˈlɔbɐ]
жарт	žart	/ʒɑrt/
житло́	žytló	/ʒɪtˈlɔ/
життя́	žyttjá	/ʒɪˈtʲːɑ/
жлу́ктити	žlukto	[ˈʒluktete]
жо́втий	žóvtyj	[ˈʒɔu̯tei̯]
жо́вчний міху́р	žóvčnyj mixúr	/ˈʒɔvt͡ʃnɪj miˈxur/
з	zi	/z/
з'їзд	zʺjizd	[ˈzjizd]
завда́ння	zavdánnja	[zɐu̯ˈdɑnʲːɐ]
завзя́ття	zavzjáttja	/zɑʋzʲɑtʲːɑ/
загро́за	zahróza	[zɐˈɦrɔzɐ]
зазвичай	zazvyčaj	[zɐzʋeˈt͡ʃɑi̯]
за́здрити	za-	[ˈzɑzdrete]
займе́нник	zajménnyk	[zɐi̯ˈmɛnːek]
за́клад	základ	[ˈzɑklɐd]
законода́вство	zakonodávstvo	[zɐkɔnɔˈdɑu̯stwɔ]
законопрое́кт	zakonoproékt	[zɐkɔnɔprɔˈɛkt]
залі́зний	zalíznyj	[zɐˈlʲiznei̯]
залі́зо	zalízo	[zɐˈlʲizɔ]
за́мок	zámok	[ˈzɑmɔk]
запита́ння	zapytánnja	[zɐpeˈtɑnʲːɐ]
запроси́ти	za-	[zɐprɔˈsɪte]
за́раз	záraz	/ˈzɑrɑz/
зарпла́та	zarpláta	[zɐrˈplɑtɐ]
заса́да	zasáda	[zɐˈsɑdɐ]
застосува́ння	zastosuvánnja	[zɐstɔsʊˈu̯ɑnʲːɐ]
засту́пник	zastupaty	[zɐˈstupnek]
за́хідний	záxidnyj	[ˈzɑxʲidnei̯]
захворі́ти	zaxvoríty	/zɑxvɔˈritɪ/
захо́плюватися	za-	[zɐˈxɔplʲʊu̯ɐtesʲɐ]
зая́ва	zajáva	[zɐˈjɑu̯ɐ]
збі́жжя	zbížžja	[ˈzʲbʲiʒʲːɐ]
збі́льшення	zbílʹšennja	[ˈzʲbʲilʲʃenʲːɐ]
збро́я	orúžžja	[ˈzbrɔjɐ]
звісно	zvidaty	[ˈzʲʋʲisnɔ]
зва́ти	zváty	/ˈzvɑtɪ/
зве́рнення	zvérnennja	[ˈzʋɛrnenʲːɐ]
зді́йснення	zdíjsnennja	[ˈzʲdʲii̯snenʲːɐ]
здоро́в'я	zdoróvʺja	[zdɔˈrɔu̯jɐ]
здрі́ти	zríty	[ˈzdʲrʲite]
зеле́ний	zelényj	[zeˈlɛnei̯]
земля́	zemljá	[zeˈmlʲɑ]
зерно́	zernó	/zɛrˈno/
зи́мородок	zýmorodok	[ˈzɪmɔrɔdɔk]
зло́чин	zlo	[ˈzlɔt͡ʃen]
зміст	zmist	[ˈzʲmʲist]
знання́	znannjá	[znɐˈnʲːɑ]
зна́ти	znáty	[ˈznɑte]
зна́чення	znáčennja	[ˈznɑt͡ʃenʲːɐ]
зно́ву	znóvu	[ˈznɔu̯ʊ]
золоти́й	zolotýj	[zɔlɔˈtɪi̯]
зо́лото	zóloto	[ˈzɔlɔtɔ]
зо́на	zóna	[ˈzɔnɐ]
зоопа́рк	zoo-	/zooˈpɑrk/
зо́шит	zóšyt	/ˈzɔʃɪt/
зрі́ти	zríty	[ˈzʲrʲite]
зрозумі́ти	zrozumíty	/zrɔzuˈmitɪ/
зу́стріч	zústrič	[ˈzustʲrʲit͡ʃ]
йо́га	jóha	[ˈjɔɦɐ]
кі́лькість	kílʹkistʹ	[ˈkʲilʲkʲisʲtʲ]
кі́лька	kílʹka	/ˈkilʲka/
кі́нчик	kínčyk	[ˈkʲint͡ʃek]
кінь	kinʹ	[ˈkʲinʲ]
кір	kir	/kir/
кіт	kit	[ˈkʲit]
кі́шка	kíška	[ˈkʲiʃkɐ]
кабіне́т	kabinét	[kɐbʲiˈnɛt]
каву́н	kavún	[kɐˈu̯un]
каза́ти	kazáty	[kɐˈzɑte]
Казахста́н	Kazaxstán	[kɐzɐˈxstɑn]
ка́зка	kázka	[ˈkɑzkɐ]
кампа́нія	kampánija	[kɐmˈpɑnʲijɐ]
кандида́т	kandydát	[kɐndeˈdɑt]
капіта́л	kapitál	[kɐpʲiˈtɑl]
кара́т	karát	[kɐˈrɑt]
кара́ти	karáty	[kɐˈrɑte]
кат	kat	[ˈkɑt]
катего́рія	katehórija	[kɐteˈɦɔrʲijɐ]
ка́федра	káfedra	[ˈkɑfedrɐ]
каца́п	kacab	[kɐˈt͡sɑp]
квадра́тний	kvadrátnyj	[kʋɐˈdrɑtnei̯]
кварти́ра	kvartýra	/kvɑrˈtɪrɑ/
керівни́к	kerivnýk	[kerʲiu̯ˈnɪk]
керівни́цтво	kerivnýctvo	[kerʲiu̯ˈnɪt͡stwɔ]
Ки́їв	Kjíjevʹ	[ˈkɪjiu̯]
кинджа́л	kyndžál	/kɪnˈd͡ʒɑl/
кисть	kystʹ	[ˈkɪsʲtʲ]
кит	kyt	[ˈkɪt]
кита́йський	Kytáj	[keˈtɑi̯sʲkei̯]
кия́нин	kyjányn	[keˈjɑnen]
кліти́на	klitýna	/klʲiˈtɪnɑ/
Кла́вдія	Klávdija	[ˈklɑu̯dʲijɐ]
кло́ччя	klóččja	[ˈklɔt͡ʃʲːɐ]
кна́йпа	knájpa	[ˈknɑi̯pɐ]
кни́жка	knýžka	[ˈknɪʒkɐ]
ко́декс	kódeks	[ˈkɔdeks]
кожу́х	kožúx	/koˈʒux/
козиро́к	kozyrók	[kɔzeˈrɔk]
ко́лір	kólir	[ˈkɔlʲir]
коле́га	koléha	[kɔˈlɛɦɐ]
комі́сія	komísija	[koˈmʲisʲijɐ]
коміте́т	komitét	[kɔmʲiˈtɛt]
кома́нда	kománda	[kɔˈmɑndɐ]
кома́ха	komáxa	/kɔˈmɑxɑ/
комп'ю́тер	kompʺjúter	[kɔmˈpjuter]
компа́нія	kompánija	[kɔmˈpɑnʲijɐ]
ко́мплекс	kómpleks	[ˈkɔmpleks]
компози́ція	kompozýcija	[kɔmpɔˈzɪt͡sʲijɐ]
коно́плі	konópli	[kɔˈnɔplʲi]
контро́ль	kontrólʹ	[kɔnˈtrɔlʲ]
конфере́нція	konferéncija	[kɔnfeˈrɛnʲt͡sʲijɐ]
конфлі́кт	konflíkt	[konˈflʲikt]
конформі́зм	konformízm	[kɔnforˈmʲizm]
конце́пція	koncépcija	[kɔnˈt͡sɛpt͡sʲijɐ]
копи́л	kopýl	[kɔˈpɪl]
корі́ння	korínnja	[koˈrʲinʲːɐ]
ко́рінь	kórinʹ	[ˈkɔrʲinʲ]
корабе́л	korabél	/kɔrɑˈbɛl/
корабе́ль	korabélʹ	/korɑˈbɛlʲ/
кордо́н	kordón	[kɔrˈdɔn]
кори́то	korýto	/kɔˈrɪtɔ/
коро́ва	koróva	/kɔˈrɔvɐ/
космі́чний	kosmíčnyj	[koˈsʲmʲit͡ʃnei̯]
Кот д'Івуа́р	Kot dʺIvuár	[kɔt dʲiu̯ʊˈɑr]
коха́ти	koxáty	[kɔˈxɑte]
кошт	košt	[ˈkɔʃt]
крі́сло	kríslo	/ˈkrislo/
краї́на	krajína	[krɐˈjinɐ]
кри́за	krýza	[ˈkrɪzɐ]
кров	krov	[ˈkrɔu̯]
крок	krok	/krɔk/
кропива́	kropyvá	[krɔpeˈu̯ɑ]
куди́	kudý	[kʊˈdɪ]
культу́ра	kulʹtúra	[kʊlʲˈturɐ]
зи́мородок	zýmorodok	[ˈzɪmɔrɔdɔk]
леле́ка	leléka	[leˈlɛkɐ]
Львів	Lʹviv	[lʲˈʋʲiu̯]
кия́нин	kyjányn	[keˈjɑnen]
кна́йпа	knájpa	[ˈknɑi̯pɐ]
число́	čysló	[t͡ʃeˈslɔ]
лише́	lyšé	[leˈʃɛ]
глід	hlid	[ˈɦlʲid]
берескле́т	bruslýna	[bereˈsklɛt]
	porá róku	[seˈzɔn]
ка́федра	káfedra	[ˈkɑfedrɐ]
ва́ше	váše	[ˈʋɑʃe]
украї́нець	ukrajínecʹ	[ʊkrɐˈjinet͡sʲ]
Я́ків	Jákiv	/ˈjɑkiu̯/
вона́	voná	[wɔˈnɑ]
воно́	vonó	[wɔˈnɔ]
вони́	voný	[wɔˈnɪ]
горі́лки	horílky	/ɦoˈrilkɪ/
англі́йський	Ánhlija	[ɐnˈɦlʲii̯sʲkei̯]
депута́т	deputát	[depʊˈtɑt]
ку́ля	kúlja	/ˈkulʲɑ/
ку́па	kúpa	/ˈkupɑ/
купе́ць	kupécʹ	/kuˈpɛt͡sʲ/
купю́ра	kupjúra	[kuˈpʲurɑ]
кур'є́р	kurʺjér	[kʊˈrjɛr]
курс	kurs	[ˈkurs]
куто́к	kut	/kuˈtɔk/
ку́хня	kúxnja	[ˈkuxnʲɐ]
лі́дер	líder	[ˈlʲider]
лі́жко	lížko	/ˈliʒko/
лі́тера	lítera	[ˈlʲiterɐ]
літера́тор	literátor	[lʲiteˈrɑtɔr]
літера́торка	literátorka	[lʲiteˈrɑtɔrkɐ]
літерату́ра	literatúra	[lʲiterɐˈturɐ]
літр	litr	[ˈlʲitr]
ліфт	lift	[ˈlʲift]
ле́бідь	lébidʹ	[ˈlɛbʲidʲ]
лебеди́ний	lebedýnyj	[lebeˈdɪnei̯]
ле́вурда	lévurda	[ˈlɛu̯ʊrdɐ]
леле́ка	leléka	[leˈlɛkɐ]
ли́пень	lýpenʹ	[ˈlɪpenʲ]
ли́сий	lýsyj	[ˈlɪsɪj]
лиси́ца	lysýca	[leˈsɪt͡sɐ]
лихома́нка	lyxománka	/lɪxoˈmɑnkɑ/
лише́	lyšé	[leˈʃɛ]
лоб	lob	[ˈlɔb]
ловела́с	lovelás	[lɔu̯eˈlɑs]
логари́фм	loharýfm	[lɔɦɐˈrɪfm]
ло́жа	lóža	[ˈlɔʒɐ]
ло́же	lóže	[ˈlɔʒe]
ло́жка	lóžka	[ˈlɔʒkɐ]
лоза́	lozá	[lɔˈzɑ]
ло́зунг	lózunh	[ˈlɔzʊnɦ]
лом	lom	[ˈlɔm]
лома́ка	lomáka	[lɔˈmɑkɐ]
ломба́рд	lombárd	[lɔmˈbɑrd]
Ло́ндон	Lóndon	[ˈlɔndɔn]
ло́но	lóno	[ˈlɔnɔ]
лопа́та	lopáta	[lɔˈpɑtɐ]
лопу́х	lopúx	[loˈpux]
лось	losʹ	[ˈlɔsʲ]
лотере́я	loteréja	[lɔteˈrɛjɐ]
лоша́	lošá	[lɔˈʃɑ]
лоша́к	lošák	[lɔˈʃɑk]
луг	luh	[ˈluɦ]
Луга́нська наро́дна респу́бліка	Luhánsʹka naródna respúblika	[lʊˈɦɑnʲsʲkɐ nɐˈrɔdnɐ reˈspublʲikɐ]
Лукі́я	Lukíja	[lʊˈkʲijɐ]
луна́	luná	[lʊˈnɑ]
лу́чник	lúčnyk	[ˈlut͡ʃnek]
Львів	Lʹviv	[lʲˈʋʲiu̯]
льо́ха	lʹóxa	/ˈlʲɔxɑ/
люби́сток	ljubýstok	[lʲʊˈbɪstɔk]
любо́в	ljubóv	[lʲʊˈbɔu̯]
люсте́рко	ljustérko	[lʲʊˈstɛrkɔ]
ляка́ти	ljakáty	[lʲɐˈkɑte]
м'я́со	mʺjáso	[ˈmjɑsɔ]
м'ясору́бка	mʺjasorúbka	/mjɑsoˈrubkɑ/
м'яч	mʺjakyj	/mjɑt͡ʃ/
мій	mij	[ˈmʲii̯]
мікроско́п	mikroskóp	/mikroˈskɔp/
мільйо́н	milʹjón	[mʲiˈlʲjɔn]
мілья́рд	milʹjárd	[mʲiˈlʲjɑrd]
міні́стр	minístr	/miˈnist(ə)r/
Мінськ	Minsʹk	[ˈmʲinʲsʲk]
мі́ра	míra	[ˈmʲirɐ]
мі́сто	místo	[ˈmʲistɔ]
мі́сяць	mísjacʹ	/ˈmisʲɑt͜sʲ/
мітла́	mitlá	/mitˈlɑ/
мітоти́чний	mitotýčnyj	/mitɔˈtɪt͡ʃnɪj/
мітохо́ндрія	mitoxóndrija	/mitoˈxɔndrijɑ/
міф	mif	/mif/
міць	mič	[ˈmʲit͡sʲ]
мішо́к	mišók	/miˈʃɔk/
ма́впа	mávpa	[ˈmɑu̯pɐ]
магази́н	mahazýn	/mɑɦɑˈzɪn/
майда́н	majdán	[mɐi̯ˈdɑn]
майно́	majnó	/ mɑjˈnɔ/
ма́ківочка	mákivočka	[ˈmɑkʲiu̯ɔt͡ʃkɐ]
мале́нький	mályj	[mɐˈlɛnʲkei̯]
ма́ма	máma	[ˈmɑmɐ]
Ма́рта	Márta	[ˈmɑrtɐ]
ма́сло	máslo	[ˈmɑslɔ]
ма́тися	mátysja	[ˈmɑtesʲɐ]
маши́на	mašýna	/mɑˈʃɪnɑ/
мед	med	[ˈmɛd]
медици́на	medycýna	[medeˈt͡sɪnɐ]
меди́чна сестра́	medýčna sestrá	/mɛˈdɪt͡ʃnɑ sɛsˈtrɑ/
меду́за	medúza	/mɛˈduzɑ/
межа́	mežá	[meˈʒɑ]
мело́діє	melódije	[meˈlɔdʲije]
мело́дією	melódijeju	[meˈlɔdʲijejʊ]
мело́дії	melódiji	[meˈlɔdʲiji]
мело́дій	melódij	[meˈlɔdʲii̯]
мело́дію	melódiju	[meˈlɔdʲijʊ]
мело́дія	melódija	[meˈlɔdʲijɐ]
мело́діям	melódijam	[meˈlɔdʲijɐm]
мело́діями	melódijamy	[meˈlɔdʲijɐme]
мело́діях	melódijax	[meˈlɔdʲijɐx]
менто́вка	mentívka	[menˈtɔu̯kɐ]
мер	mer	/mɛr/
ме́ртвий	mértvyj	[ˈmɛrtvɪj]
мета́	metá	[meˈtɑ]
металу́рг	metalúrh	/metɑˈlurɦ/
ме́тод	métod	[ˈmɛtɔd]
ме́тр	métr	[ˈmɛtr]
механі́зм	mexanízm	[mexɐˈnʲizm]
механі́ст	mexaníst	[mexɐˈnʲist]
меч	meč	/mɛt͡ʃ/
ме́шкання	méškannja	/ˈmɛʃkɑnʲːɑ/
ме́шкати	méškaty	[ˈmɛʃkɐte]
моє́	mojé	[mɔˈjɛ]
мо́ва	móva	/ˈmɔvɑ/
мовозна́вство	movoznávstvo	/movoˈznɑvstvo/
моде́ль	modélʹ	[mɔˈdɛlʲ]
модри́на	modrýna	/modˈrɪnɑ/
мо́зок	mózok	/ˈmɔzɔk/
молито́вник	molytóvnyk	[mɔleˈtɔu̯nek]
молоття́	molottjá	[mɔlɔˈtʲːɑ]
молотьба́	molotʹbá	[mɔlɔˈdʲbɑ]
моме́нт	momént	[mɔˈmɛnt]
мона́рхіє	monárxije	[mɔˈnɑrxʲije]
мона́рхією	monárxijeju	[mɔˈnɑrxʲijejʊ]
мона́рхії	monárxiji	[mɔˈnɑrxʲiji]
мона́рхій	monárxij	[mɔˈnɑrxʲii̯]
мона́рхію	monárxiju	[mɔˈnɑrxʲijʊ]
мона́рхія	monárxija	[mɔˈnɑrxʲijɐ]
мона́рхіям	monárxijam	[mɔˈnɑrxʲijɐm]
мона́рхіях	monárxijax	[mɔˈnɑrxʲijɐx]
мороз	moroz	[mɔˈrɔz]
моя́	mojá	[mɔˈjɑ]
мрі́яти	mrity	[ˈmrʲijɐte]
музе́й	muzéj	[mʊˈzɛi̯]
ні	ni	[ˈnʲi]
ніж	niž	[ˈnʲiʒ]
ні́здре	nízdre	[ˈnʲizdre]
ні́здрею	nízdreju	[ˈnʲizdrejʊ]
ні́здрю	nízdrju	[ˈnʲizdʲrʲʊ]
ні́здрями	nízdrjamy	[ˈnʲizdʲrʲɐme]
ні́здрях	nízdrjax	[ˈnʲizdʲrʲɐx]
ніко́ли	nikóly	/niˈkɔlɪ/
ні́мець	nímecʹ	[ˈnʲimet͡sʲ]
німи́й	nimýj	[nʲiˈmɪi̯]
ніхто	nixtó	/niˈxtɔ/
на́віть	návitʹ	/ˈnɑvitʲ/
на́видіти	návydity	[ˈnɑu̯edʲite]
наді́йність	nadíjnistʹ	/nɑˈdijnisʲtʲ/
зи́мородок	zýmorodok	[ˈzɪmɔrɔdɔk]
леле́ка	leléka	[leˈlɛkɐ]
Львів	Lʹviv	[lʲˈʋʲiu̯]
кия́нин	kyjányn	[keˈjɑnen]
кна́йпа	knájpa	[ˈknɑi̯pɐ]
число́	čysló	[t͡ʃeˈslɔ]
лише́	lyšé	[leˈʃɛ]
глід	hlid	[ˈɦlʲid]
берескле́т	bruslýna	[bereˈsklɛt]
	porá róku	[seˈzɔn]
ка́федра	káfedra	[ˈkɑfedrɐ]
ва́ше	váše	[ˈʋɑʃe]
украї́нець	ukrajínecʹ	[ʊkrɐˈjinet͡sʲ]
Я́ків	Jákiv	/ˈjɑkiu̯/
вона́	voná	[wɔˈnɑ]
воно́	vonó	[wɔˈnɔ]
вони́	voný	[wɔˈnɪ]
горі́лки	horílky	/ɦoˈrilkɪ/
англі́йський	Ánhlija	[ɐnˈɦlʲii̯sʲkei̯]
депута́т	deputát	[depʊˈtɑt]
нада́ння́	nadánnjá	[nɐˈdɑˈnʲːɑ]
надворі	na	[nɐˈdwɔrʲi]
на́ймит	nájmyt	[ˈnɑi̯met]
на́ймичка	nájmyčka	[ˈnɑi̯met͡ʃkɐ]
на́мір	námir	[ˈnɑmʲir]
на́рід	nárid	[ˈnɑrʲid]
нара́зі	na	[nɐˈrɑzʲi]
на́слідок	náslidok	[ˈnɑsʲlʲidɔk]
настро́їти	na-	[nɐˈstrɔjite]
настроювати	nastrojuvaty	[nɐˈstrɔjʊu̯ɐte]
націона́льний	nacionálʹnyj	[nɐt͡sʲiɔˈnɑlʲnei̯]
на́ція	nácija	[ˈnɑt͡sʲijɐ]
на́ша	náša	[ˈnɑʃɐ]
на́ше	náše	[ˈnɑʃe]
ная́вність	najávnistʹ	[nɐˈjɑu̯nʲisʲtʲ]
не	ne	[ˈnɛ]
небезпе́ка	ne-	[nebeˈzpɛkɐ]
Нева́	Nevá	[neˈu̯ɑ]
неврологі́чний	nevrolohíčnyj	[ˌnewrɔlɔˈɦit͡ʃnɪj]
неді́ля	nedílja	[neˈdʲilʲɐ]
необхі́дність	neobxídnistʹ	[neoˈbxʲidʲnʲisʲtʲ]
Неоні́ла	Neoníla	[neoˈnʲilɐ]
нерво́ва систе́ма	nervóva systéma	/nɛrˈvɔvɑ sɪsˈtɛmɑ/
ни́зка	nýzka	[ˈnɪzkɐ]
низьки́й	nyzʹkýj	[neˈzʲkɪi̯]
но́рма	nórma	[ˈnɔrmɐ]
но́чвах	nóčvax	[ˈnɔt͡ʃʋɐx]
но́чви	nóčvy	[ˈnɔt͡ʃʋe]
об'є́днання	obʺjédnannja	[ɔˈbjɛdnɐnʲːɐ]
об'є́кт	obʺjékt	[ɔˈbjɛkt]
обі́д	obíd	[oˈbʲid]
обговоре́ння	obhovorénnja	[ɔbɦɔu̯ɔˈrɛnʲːɐ]
о́бласть	óblastʹ	[ˈɔblɐsʲtʲ]
обли́ччя	oblýččja	[ɔˈblɪt͡ʃʲːɐ]
обо́в'язок	obóvʺjazok	[ɔˈbɔu̯jɐzɔk]
обо́жнювати	obóžnjuvaty	[ɔˈbɔʒnʲʊu̯ɐte]
обсервато́рія	observatórija	[ɔbserʋɐˈtɔrʲijɐ]
о́бсяг	óbsjah	[ˈɔbsʲɐɦ]
о́гляд	óhljad	[ˈɔɦlʲɐd]
оди́н	odyn	/oˈdɪn/
озе́рце́	ozércé	[ɔˈzɛrt͡se]
озна́ка	oznáka	[ɔˈznɑkɐ]
о́ко	óko	[ˈɔkɔ]
оліве́ць	olivécʹ	[ɔlʲiˈu̯ɛt͡sʲ]
олі́я	olíja	[oˈlʲijɐ]
ола́дка	oládka	[ɔˈlɑdkɐ]
ола́док	oládok	[ɔˈlɑdɔk]
Олекса́ндр	Oleksándr	[ɔleˈksɑndr]
ома́н	omán	[ɔˈmɑn]
ону́ка	onúka	[oˈnukɐ]
опера́ція	operácija	[ɔpeˈrɑt͡sʲijɐ]
опози́ція	opozýcija	[ɔpɔˈzɪt͡sʲijɐ]
ора́нжевий	oránževyj	[ɔˈrɑnʒeu̯ei̯]
осі́нній	osínnij	[ɔˈsinʲːij]
осві́та	osvíta	[ɔˈsʲʋʲitɐ]
осно́ва	osnóva	[ɔˈsnɔu̯ɐ]
особли́вість	osoblývistʹ	[ɔsɔˈblɪu̯ʲisʲtʲ]
оста́нній	ostánnij	[osˈtɑnʲːij]
охоро́на	oxoróna	[ɔxɔˈrɔnɐ]
охоро́нець	oxorónecʹ	[ɔxɔˈrɔnet͡sʲ]
оці́нка	ocínka	[oˈt͡sʲinkɐ]
п'є́са	pʺjésa	[ˈpjɛsɐ]
п'я́ний	pʺjányj	[ˈpjɑnei̯]
п'я́тий	pʺjatʹ	[ˈpjɑtei̯]
п'ятна́дцять	pʺjatnadcjatʹ	[pjɐˈtnɑd͡zʲt͡sʲɐtʲ]
п'я́тниця	pʺjátnycja	[ˈpjɑtnet͡sʲɐ]
п'ять	pʺjatʹ	[ˈpjɑtʲ]
півку́ля	pivkúlja	[pʲiu̯ˈkulʲɐ]
підви́щення	pidvýščennja	[pʲiˈdʋɪʃt͡ʃenʲːɐ]
підло́га	pidlóha	/pidˈlɔɦɑ/
підприє́мство	pidpryjémstvo	[pʲidpreˈjɛmstwɔ]
підста́ва	pidstáva	[pʲiˈd͡zstɑu̯ɐ]
пі́дсумок	pídsumok	/ˈpitsumɔk/
підтри́мка	pidtrýmka	[pʲiˈdtrɪmkɐ]
післяза́втра	píslja	[pʲisʲlʲɐˈzɑu̯trɐ]
пі́сня	písnja	/ˈpisʲnʲɑ/
пісо́к	pisók	[pʲiˈsɔk]
піч	pič	[ˈpʲit͡ʃ]
па́дати	pádaty	/ˈpadatɪ/
пала́ц	palác	[pɐˈlɑt͡s]
па́ливо	pályvo	[ˈpɑleu̯ɔ]
па́м'ять	pámʺjatʹ	/ˈpɑmjɑtʲ/
папу́га	papúha	/paˈpuɦa/
парашу́т	parašút	/pɑrɑˈʃut/
парла́мент	parláment	[pɐrˈlɑment]
партне́р	partnér	[pɐrˈtnɛr]
пелю́шка	peljúxa	[peˈlʲuʃkɐ]
пе́нсія	pénsija	[ˈpɛnʲsʲijɐ]
Пенсильва́нія	Pensylʹvánija	[penselʲˈʋɑnʲijɐ]
перга́	perhá	[perˈɦɑ]
перева́га	pereváha	[pereˈu̯ɑɦɐ]
перегово́ри	perehovóry	[pereɦɔˈu̯ɔre]
перемо́га	peremóha	[pereˈmɔɦɐ]
пересі́чний	peresíčnyj	[pereˈsʲit͡ʃnei̯]
перо́	peró	[peˈrɔ]
перспекти́ва	perspektýva	[perspeˈktɪu̯ɐ]
пе́рший	odýn	[ˈpɛrʃei̯]
Петро́	Petró	[peˈtrɔ]
пече́ра	pečéra	/peˈt͡ʃɛrɑ/
пи́во	pývo	/ˈpɪvo/
пивова́р	pyvovár	[peu̯ɔˈu̯ɑr]
пивова́рство	pyvovárstvo	[peu̯ɔˈu̯ɑrstwɔ]
пирі́г	pyríh	[peˈrʲiɦ]
писа́ти	pysáty	[peˈsɑte]
письме́нник	pysʹménnyk	[peˈsʲmɛnːek]
пита́ння	pytánnja	[peˈtɑnʲːɐ]
пита́ти	pytáty	[peˈtɑte]
плака́т	plakát	[plɐˈkɑt]
пла́кати	plákaty	[ˈplɑkɐte]
план	plan	[ˈplɑn]
планта́ція	plantácija	[plɐnˈtɑt͡sʲijɐ]
пла́та	pláta	[ˈplɑtɐ]
плати́ти	platýty	[plɐˈtɪte]
плече́	plečé	[pleˈt͡ʃɛ]
пло́ща	plóšča	[ˈplɔʃt͡ʃɐ]
плутокра́тіє	plutokrátije	[plʊtɔˈkrɑtʲije]
плутокра́тією	plutokrátijeju	[plʊtɔˈkrɑtʲijejʊ]
плутокра́тії	plutokrátiji	[plʊtɔˈkrɑtʲiji]
плутокра́тій	plutokrátij	[plʊtɔˈkrɑtʲii̯]
плутокра́тію	plutokrátiju	[plʊtɔˈkrɑtʲijʊ]
плутокра́тія	plutokrátija	[plʊtɔˈkrɑtʲijɐ]
плутокра́тіям	plutokrátijam	[plʊtɔˈkrɑtʲijɐm]
плутокра́тіями	plutokrátijamy	[plʊtɔˈkrɑtʲijɐme]
плутокра́тіях	plutokrátijax	[plʊtɔˈkrɑtʲijɐx]
плутократи́чний	plutokratýčnyj	[plʊtɔkrɐˈtɪt͡ʃnei̯]
пля́шка	pljáška	/ˈplʲɑʃkɑ/
поєдна́ння	pojednánnja	[pɔjeˈdnɑnʲːɐ]
по́їзд	pójizd	[ˈpɔjizd]
по́верх	póverx	/ˈpɔvɛrx/
по́вний	póvnyj	[ˈpɔu̯nei̯]
повста́ння	povstánnja	/pɔwˈstɑnʲːɑ/
по́гляд	póhljad	[ˈpɔɦlʲɐd]
погро́за	pohróza	[pɔˈɦrɔzɐ]
подру́га	podrúha	[poˈdruɦɐ]
пози́ція	pozýcija	[pɔˈzɪt͡sʲijɐ]
пока́зник	pokáznyk	[pɔˈkɑznek]
поколі́ння	pokolínnja	[pɔkoˈlʲinʲːɐ]
Полі́на	Polína	[poˈlʲinɐ]
політи́чний	politýčnyj	[pɔlʲiˈtɪt͡ʃnei̯]
полови́на	polovýna	[pɔlɔˈu̯ɪnɐ]
поло́ження	polóžennja	[pɔˈlɔʒenʲːɐ]
полу́мисок	polúmysok	[poˈlumesɔk]
помаранчевий	pomarančevyj	[pɔmɐˈrɑnt͡ʃeu̯ei̯]
поме́шкання	poméškannja	/poˈmɛʃkɑnʲːɑ/
поня́ття	ponjáttja	[pɔˈnʲɑtʲːɐ]
по́піл	pópil	[ˈpɔpʲil]
Пороше́нко	Porošénko	[pɔrɔˈʃɛnkɔ]
поря́док	porjádok	[pɔˈrʲɑdɔk]
посі́бник	posíbnyk	[poˈsʲibnek]
поса́да	posáda	[pɔˈsɑdɐ]
послідо́вник	poslidóvnyk	[pɔsʲlʲiˈdɔu̯nek]
посольство	slaty	[pɔˈsɔlʲstwɔ]
по́сті́ль	póstílʹ	/ˈpɔstilʲ/
постано́ва	postanóva	[pɔstɐˈnɔu̯ɐ]
поті́к	potík	[poˈtʲik]
зи́мородок	zýmorodok	[ˈzɪmɔrɔdɔk]
леле́ка	leléka	[leˈlɛkɐ]
Львів	Lʹviv	[lʲˈʋʲiu̯]
кия́нин	kyjányn	[keˈjɑnen]
кна́йпа	knájpa	[ˈknɑi̯pɐ]
число́	čysló	[t͡ʃeˈslɔ]
лише́	lyšé	[leˈʃɛ]
глід	hlid	[ˈɦlʲid]
берескле́т	bruslýna	[bereˈsklɛt]
	porá róku	[seˈzɔn]
ка́федра	káfedra	[ˈkɑfedrɐ]
ва́ше	váše	[ˈʋɑʃe]
украї́нець	ukrajínecʹ	[ʊkrɐˈjinet͡sʲ]
Я́ків	Jákiv	/ˈjɑkiu̯/
вона́	voná	[wɔˈnɑ]
воно́	vonó	[wɔˈnɔ]
вони́	voný	[wɔˈnɪ]
горі́лки	horílky	/ɦoˈrilkɪ/
англі́йський	Ánhlija	[ɐnˈɦlʲii̯sʲkei̯]
депута́т	deputát	[depʊˈtɑt]
потенціа́л	potenciál	[pɔtenʲt͡sʲiˈɑl]
потре́ба	potréba	[pɔˈtrɛbɐ]
потяга́ти	po-	[pɔtʲɐˈɦɑte]
по́хіть	póxitʹ	[ˈpɔxʲitʲ]
поча́ток	počátok	[pɔˈt͡ʃɑtɔk]
по́шук	póšuk	[ˈpɔʃʊk]
пріорите́т	priorytét	[prʲiɔreˈtɛt]
пра́вда	právda	[ˈprɑu̯dɐ]
пра́вило	právylo	[ˈprɑu̯elɔ]
пра́ктика	práktyka	[ˈprɑktekɐ]
працюва́ти	pracjuváty	[prɐt͡sʲʊˈu̯ɑte]
предме́т	predmét	[preˈdmɛt]
прем'є́р	premʺjér	[preˈmjɛr]
прибу́ток	prybútok	[preˈbutɔk]
при́від	prývid	[ˈprɪu̯ʲid]
при́голосний	prýholosnyj	[ˈprɪɦɔlɔsnei̯]
призна́чення	pryznáčennja	[preˈznɑt͡ʃenʲːɐ]
прийти́	pry-	[prei̯ˈtɪ]
прикла́д	pryklád	[preˈklɑd]
при́нцип	prýncyp	[ˈprɪnt͡sep]
прихи́льник	pryxýlʹnyk	[preˈxɪlʲnek]
причи́на	pryčýna	[preˈt͡ʃɪnɐ]
провінціа́льний	provinciálʹnyj	/provint͡siˈɑlʲnɪj/
програ́ма	prohráma	/proˈɦrɑmɑ/
проду́кт	prodúkt	[proˈdukt]
проду́кція	prodúkcija	[proˈdukt͡sʲijɐ]
прое́кт	proékt	/proˈɛkt/
прожива́ння	prožyvánnja	/proˈʒɪvɑnʲːɑ/
пролетарі всіх країн, єднайтеся!	proletari vsix krajin, jednajtesja!	[prɔletɐrʲi ʍsʲix krɐjin, jednɐi̯tesʲɐ]
пропози́ція	propozýcija	[prɔpɔˈzɪt͡sʲijɐ]
про́стір	próstir	[ˈprɔsʲtʲir]
про́сьба	prósʹba	[ˈprɔzʲbɐ]
проте́ст	protést	[prɔˈtɛst]
профе́сор	profésor	[prɔˈfɛsɔr]
процеду́ра	procedúra	[prɔt͡seˈdurɐ]
птах	ptax	[ˈptɑx]
пта́шка	ptáška	/ˈptɑʃkɑ/
публіка́ція	publikácija	[pʊblʲiˈkɑt͡sʲijɐ]
пу́головок	púholovok	[ˈpuɦɔlɔu̯ɔk]
пункт	punkt	[ˈpunkt]
пусте́ля	pustélja	/puˈstɛlʲɑ/
пюпі́тр	pjupítr	[pʲʊˈpʲitr]
р	r	/r/
рі́вень	rívenʹ	[ˈrʲiu̯enʲ]
рі́дний	rídnyj	[ˈrʲidnei̯]
рій	rij	/rij/
ріка́	riká	[rʲiˈkɑ]
рі́чка	ríčka	[ˈrʲit͡ʃkɐ]
річни́ця	ričnýcja	[rʲiˈt͡ʃnɪt͡sʲɐ]
ра́мка	rámka	[ˈrɑmkɐ]
ра́птом	ráptom	/ˈrɑptom/
ра́са	rása	[ˈrɑsɐ]
регіо́н	rehión	[reɦʲiˈɔn]
регулюва́ння	rehuljuvánnja	[reɦʊlʲʊˈu̯ɑnʲːɐ]
режи́м	režým	[reˈʒɪm]
ре́йтинг	réjtynh	[ˈrɛi̯tenɦ]
релі́гія	relíhija	/rɛˈliɦijɑ/
рестора́н	restorán	[restɔˈrɑn]
рефо́рма	refórma	[reˈfɔrmɐ]
реформува́ння	reformuvánnja	[refɔrmʊˈu̯ɑnʲːɐ]
ре́я	réja	[ˈrɛjɐ]
ри́ба	rýba	[ˈrɪbɐ]
ри́бка	rýbka	[ˈrɪbkɐ]
ри́са	rýsa	/ˈrɪsɑ/
роди́на	rodýna	[rɔˈdɪnɐ]
роже́вий	rožévyj	[rɔˈʒɛu̯ei̯]
ро́згляд	rózhljad	[ˈrɔzɦlʲɐd]
ро́зділ	rózdil	/ˈrɔzdil/
розмі́р	rozmír	[roˈzʲmʲir]
розмо́ва	roz-	[rɔˈzmɔu̯ɐ]
розорений	rozoryty	[rɔˈzɔrenei̯]
розро́бка	rozróbka	[rɔˈzrɔbkɐ]
розташува́ти	roztašuváty	/roztɑʃuˈvɑtɪ/
розумі́ння	rozumínnja	[rɔzʊˈmʲinʲːɐ]
роль	rolʹ	[ˈrɔlʲ]
рома́н	román	[rɔˈmɑn]
ропу́ха	ropúxa	[roˈpuxɐ]
росі́йська мо́ва	rosíjsʹka móva	[roˈsʲii̯sʲkɐ ˈmɔu̯ɐ]
рукави́ця	rukavýcja	[rʊkɐˈu̯ɪt͡sʲɐ]
ру́ський	rusʹ	[ˈrusʲkei̯]
рух	rux	[ˈrux]
рушни́ця	rušnýcja	/ruʃˈnɪt͡sʲɑ/
сім	sim	[ˈsʲim]
сі́ни	síny	[ˈsʲine]
сі́чень	síčenʹ	[ˈsʲit͡ʃenʲ]
сад	sad	[ˈsɑd]
сала́товий	salátovyj	[sɐˈlɑtɔu̯ei̯]
самоврядува́ння	samovrjaduvánnja	[sɐmɔu̯rʲɐdʊˈu̯ɑnʲːɐ]
самості́йно	samostíjno	[sɐmoˈsʲtʲii̯nɔ]
самши́т	samšýt	[sɐmˈʃɪt]
світа́нок	svitánok	/svʲiˈtɑnok/
сві́чка	svíčka	[ˈsʲʋʲit͡ʃkɐ]
свиня́	svynjá	/svɪˈnʲɑ/
своє́	svojé	[swɔˈjɛ]
свобо́да	svobóda	[swɔˈbɔdɐ]
свя́то	svjáto	[ˈsʲʋʲɑtɔ]
	porá róku	[seˈzɔn]
семіна́р	seminár	[semʲiˈnɑr]
сентимента́льний	sentymentálʹnyj	/sentɪmenˈtɑlʲnɪj/
середа́	seredá	[sereˈdɑ]
сере́дній рід	serédnij rid	[seˈrɛdʲnʲij rʲid]
середо́вище	seredóvyšče	[sereˈdɔu̯eʃt͡ʃe]
серп	serp	/serp/
се́рце	sérce	[ˈsɛrt͡se]
сестра́	sestrá	[seˈstrɑ]
сиді́ти	sydíty	[seˈdʲite]
символі́чний	symvolíčnyj	[semwoˈlʲit͡ʃnei̯]
син	syn	[ˈsɪn]
си́ній	sýnij	[ˈsɪnʲii̯]
скі́льки	skílʹky	[ˈsʲkʲilʲkɪ]
скарб	skarb	[ˈskɑrb]
ске́ля	skélja	/ˈskɛlʲɑ/
ске́на	skéna	[skenɐ]
		
сковорода́	skovorodá	[skɔu̯ɔrɔˈdɑ]
ско́ро	skóro	[ˈskɔrɔ]
сліпи́й	slipýj	[slʲiˈpɪj]
Сла́ва Ісу́су Христу́!	Sláva Isúsu Xrystú!	[ˈslɑu̯ɐ iˈsusʊ xreˈstu]
слов'я́нський	slovʺjánsʹkyj	[slɔu̯ˈjɑnʲsʲkei̯]
слу́жба	slúžba	[ˈsluʒbɐ]
смі́ли́вість	smílývistʹ	/smiˈlɪvistʲ/
смара́гд	smaráhd	[smɐˈrɑɦd]
смара́гдовий	smaráhdovyj	[smɐˈrɑɦdɔu̯ei̯]
смерть	smertʹ	/smɛrtʲ/
сніг	snih	[ˈsʲnʲiɦ]
собо́р	sobór	/soˈbɔr/
соліда́рність	solidárnistʹ	[sɔlʲiˈdɑrnʲisʲtʲ]
солений	solenyj	[ˈsɔlenei̯]
солове́й	solovij	[sɔlɔˈu̯ɛi̯]
Соломі́я	Solomíja	[sɔloˈmʲijɐ]
сон	son	[ˈsɔn]
Со́нце	Sónce	[ˈsɔnt͡se]
со́нячний	sónjačnyj	/ˈsɔnʲɑt͡ʃnɪj/
соро́чка	soróčka	[sɔˈrɔt͡ʃkɐ]
со́сна́	sósná	/sosˈnɑ/
Со́фія	Sófija	[ˈsɔfʲijɐ]
сою́з	sojúz	[sɔˈjuz]
спі́рний	spírnyj	[ˈsʲpʲirnei̯]
Спаса	spastý	[ˈspɑsɐ]
спис	spys	/spɪs/
зи́мородок	zýmorodok	[ˈzɪmɔrɔdɔk]
леле́ка	leléka	[leˈlɛkɐ]
Львів	Lʹviv	[lʲˈʋʲiu̯]
кия́нин	kyjányn	[keˈjɑnen]
кна́йпа	knájpa	[ˈknɑi̯pɐ]
число́	čysló	[t͡ʃeˈslɔ]
лише́	lyšé	[leˈʃɛ]
глід	hlid	[ˈɦlʲid]
берескле́т	bruslýna	[bereˈsklɛt]
	porá róku	[seˈzɔn]
ка́федра	káfedra	[ˈkɑfedrɐ]
ва́ше	váše	[ˈʋɑʃe]
украї́нець	ukrajínecʹ	[ʊkrɐˈjinet͡sʲ]
Я́ків	Jákiv	/ˈjɑkiu̯/
вона́	voná	[wɔˈnɑ]
воно́	vonó	[wɔˈnɔ]
вони́	voný	[wɔˈnɪ]
горі́лки	horílky	/ɦoˈrilkɪ/
англі́йський	Ánhlija	[ɐnˈɦlʲii̯sʲkei̯]
депута́т	deputát	[depʊˈtɑt]
справ	sprav	[ˈsprɑu̯]
спра́вам	správam	[ˈsprɑu̯ɐm]
спра́вами	správamy	[ˈsprɑu̯ɐme]
спра́вах	správax	[ˈsprɑu̯ɐx]
спра́вжній	správžnij	[ˈsprɑu̯ʒnʲii̯]
спра́ви	správy	[ˈsprɑu̯e]
спра́ву	správu	[ˈsprɑu̯ʊ]
спро́ба	spróba	[ˈsprɔbɐ]
стіле́ць	stolecʹ	/stiˈlɛt͡sʲ/
стіна́	stiná	[sʲtʲiˈnɑ]
ста́влення	stávlennja	[ˈstɑu̯lenʲːɐ]
Станісла́в	Stanisláv	/stɑɲiˈslɑu̯/
станда́рт	standárt	[stɐnˈdɑrt]
стаття́	stattjá	[stɐˈtʲːɑ]
ста́тус	státus	[ˈstɑtʊs]
ство́рення	stvórennja	[ˈstwɔrenʲːɐ]
сте́ля	stélja	/ˈstɛlʲɑ/
степ	step	[ˈstɛp]
Стефа́нія	Stefánija	[steˈfɑnʲijɐ]
сто	sto	/stɔ/
столі́ття	stolíttja	[stoˈlʲitʲːɐ]
столи́ця	stolýcja	[stɔˈlɪt͡sʲɐ]
сторі́нка	storínka	/stoˈrinkɑ/
сторона́	storoná	[stɔrɔˈnɑ]
стрі́чка	stríčka	/ˈstrʲit͡ʃkɐ/
стрі́чки	stríčky	/ˈstrʲit͡ʃkɪ/
стра́ва	stráva	[ˈstrɑu̯ɐ]
страшни́й	strašnýj	[strɐˈʃnɪi̯]
стро́їти	strójity	[ˈstrɔjite]
структу́ра	struktúra	[strʊˈkturɐ]
студе́нт	studént	/stuˈdɛnt/
стяг	stjah	[ˈsʲtʲɑɦ]
субо́та	subóta	[sʊˈbɔtɐ]
суддя́	suddjá	/suˈdʲːɑ/
сумлі́ння	sumlínnja	[sʊˈmlʲinʲːɐ]
супру́гам	suprúham	[sʊˈpruɦɐm]
супру́гами	suprúhamy	[sʊˈpruɦɐme]
супру́гах	suprúhax	[sʊˈpruɦɐx]
супру́гою	suprúhoju	[sʊˈpruɦɔjʊ]
Суса́нна	Susánna	[sʊˈsɑnːɐ]
суспі́льство	suspílʹstvo	/susˈpilʲstvo/
суть	sutʹ	[ˈsutʲ]
Схід	Sxid	[ˈsʲxʲid]
-сь	-sʹ	[sʲ]
сього́дні	sʹohódni	[sʲɔˈɦɔdʲnʲi]
ся́ти	sjáty	[ˈsʲɑte]
сяя́ти	sjáty	[sʲɐˈjɑte]
ті́льки	tílʹky	[ˈtʲilʲkɪ]
ті́стечко	tístečko	[ˈtʲistet͡ʃkɔ]
ті́тка	títka	[ˈtʲitkɐ]
та	ta	/tɑ/
Таї́сія	Tajísija	[tɐˈjisʲijɐ]
табли́ця	tablýcja	/tɑbˈlɪt͡sʲɑ/
так	tak	[ˈtɑk]
там	tam	[ˈtɑm]
та́не́ць	tánécʹ	[ˈtɑˈnɛt͡sʲ]
танцюва́ти	tancjuváty	[tɐnʲt͡sʲʊˈu̯ɑte]
тарі́лка	tarílka	[tɐˈrʲilkɐ]
тарга́н	tarhán	/tɑrˈɦɑn/
та́то	táto	[ˈtɑtɔ]
твій	tvij	[ˈtʲʋʲii̯]
твір	tvir	[ˈtʲʋʲir]
твари́на	tvarýna	[tʋɐˈrɪnɐ]
твоє́	tvojé	[twɔˈjɛ]
твоя́	tvojá	[twɔˈjɑ]
теа́тр	teátr	[teˈɑtr]
текст	tekst	/tɛkst/
телеві́зор	televízor	/tɛlɛˈvizor/
те́ма	téma	[ˈtɛmɐ]
те́мний	témnyj	[ˈtɛmnei̯]
тенде́нція	tendéncija	[tenˈdɛnʲt͡sʲijɐ]
тео́ріє	teórije	[teˈɔrʲije]
тео́рією	teórijeju	[teˈɔrʲijejʊ]
тео́рії	teóriji	[teˈɔrʲiji]
тео́рій	teórij	[teˈɔrʲii̯]
тео́рію	teóriju	[teˈɔrʲijʊ]
тео́рія	teórija	[teˈɔrʲijɐ]
тео́ріям	teórijam	[teˈɔrʲijɐm]
тео́ріями	teórijamy	[teˈɔrʲijɐme]
тео́ріях	teórijax	[teˈɔrʲijɐx]
терапевти́чний	terapevtýčnyj	[terɐpeu̯ˈtɪt͡ʃnei̯]
те́рен	ternýna	[ˈtɛren]
терито́рія	terytórija	[tereˈtɔrʲijɐ]
те́рмін	términ	[ˈtɛrmʲin]
те́рти	térty	[ˈtɛrte]
техноло́гія	texnolóhija	[texnɔˈlɔɦʲijɐ]
ти	ty	[ˈtɪ]
тка́ти	tkáty	/ˈtkatɪ/
тоді́	todí	[toˈdʲi]
том	tom	[ˈtɔm]
то́нна	tónna	[ˈtɔnːɐ]
торгі́вля	torhívlja	[torˈɦʲiu̯lʲɐ]
то́чка	tóčka	[ˈtɔt͡ʃkɐ]
то́що	tóščo	/ˈtɔʃt͡ʃo/
трі́щина	tríščyna	/ˈtriʃt͡ʃɪnɑ/
тра́вень	trávenʹ	[ˈtrɑu̯enʲ]
траге́діє	trahédije	[trɐˈɦɛdʲije]
траге́дією	trahédijeju	[trɐˈɦɛdʲijejʊ]
траге́дію	trahédiju	[trɐˈɦɛdʲijʊ]
траге́діям	trahédijam	[trɐˈɦɛdʲijɐm]
тради́ція	tradýcija	[trɐˈdɪt͡sʲijɐ]
тре́ба	tréba	[ˈtrɛbɐ]
три	try	/trɪ/
трику́тний	trykútnyj	[treˈkutnei̯]
труп	trup	[ˈtrup]
туале́т	tualét	/tuɑˈlɛt/
туди́	tudý	[tʊˈdɪ]
тура	tura	[tʊˈrɑ]
тут	tut	[ˈtut]
тхір	txir	[ˈtʲxʲir]
тюрма́	tjurmá	[tʲʊrˈmɑ]
тютю́н	tjutjún	/tʲuˈtʲun/
тяга́ти	tjaháty	[tʲɐˈɦɑte]
у ме́не є пита́ння	u méne je pytánnja	[ʊ ˈmɛne je peˈtɑnʲːɐ]
ува́га	uváha	[ʊˈu̯ɑɦɐ]
уго́да	uhóda	[ʊˈɦɔdɐ]
уже́	vže	[ʊˈʒɛ]
Украї́на	Ukrájna	[ʊkrɐˈjinɐ]
украї́нець	ukrajínecʹ	[ʊkrɐˈjinet͡sʲ]
украї́нська	ukrajínsʹka	/ukrɑˈjinʲsʲkɑ/
украї́нська мо́ва	ukrajínsʹka móva	/ukrɑˈjinʲsʲkɑ ˈmɔwɑ/
украї́нський	Ukrajína	/ukrɑˈjinʲsʲkɪj/
У́мань	Húmanʹ	[ˈumɐnʲ]
умо́ва	umóva	[ʊˈmɔu̯ɐ]
університе́т	universytét	[ʊnʲiu̯erseˈtɛt]
управлі́ння	upravlínnja	[ʊprɐu̯ˈlʲinʲːɐ]
у́ряд	úrjad	[ˈurʲɐd]
у́спіх	úspix	[ˈusʲpʲix]
устано́ва	ustanóva	[ʊstɐˈnɔu̯ɐ]
у́часть	účastʹ	[ˈut͡ʃɐsʲtʲ]
учи́тель	včýtelʹ	[ʊˈt͡ʃɪtelʲ]
філіжа́нка	filižánka	[fʲilʲiˈʒɑnkɐ]
фільм	filʹm	[ˈfʲilʲm]
фінансува́ння	finansuvánnja	[fʲinɐnsʊˈu̯ɑnʲːɐ]
фіоле́товий	fiolétovyj	[fʲiɔˈlɛtɔu̯ei̯]
фах	fax	[ˈfɑx]
фахіве́ць	faxivécʹ	[fɐxʲiˈu̯ɛt͡sʲ]
фонд	fond	[ˈfɔnd]
фонта́н	fontán	/fɔnˈtɑn/
фотогра́фіє	fotohráfije	[fɔtɔˈɦrɑfʲije]
фотогра́фії	fotohráfiji	[fɔtɔˈɦrɑfʲiji]
фотогра́фій	fotohráfij	[fɔtɔˈɦrɑfʲii̯]
фотогра́фію	fotohráfiju	[fɔtɔˈɦrɑfʲijʊ]
фотогра́фія	fotohráfija	[fɔtɔˈɦrɑfʲijɐ]
фотогра́фіям	fotohráfijam	[fɔtɔˈɦrɑfʲijɐm]
фотогра́фіями	fotohráfijamy	[fɔtɔˈɦrɑfʲijɐme]
фотогра́фіях	fotohráfijax	[fɔtɔˈɦrɑfʲijɐx]
фра́кція	frákcija	[ˈfrɑkt͡sʲijɐ]
францу́зький	francúzʹkyj	[frɐnˈt͡suzʲkei̯]
фуа̀-гра́	fuà-hrá	[fʊˈɑ ˈɦrɑ]
фу́нкція	fúnkcija	[ˈfunkt͡sʲijɐ]
фюзеля́ж	fjuzeljáž	[fʲʊzeˈlʲɑʒ]
Ха́ва	Xáva	[ˈxɑu̯ɐ]
хай	xaj	[ˈxɑi̯]
ха́ле́па	xálépa	[ˈxɑˈlɛpɐ]
зи́мородок	zýmorodok	[ˈzɪmɔrɔdɔk]
леле́ка	leléka	[leˈlɛkɐ]
Львів	Lʹviv	[lʲˈʋʲiu̯]
кия́нин	kyjányn	[keˈjɑnen]
кна́йпа	knájpa	[ˈknɑi̯pɐ]
число́	čysló	[t͡ʃeˈslɔ]
лише́	lyšé	[leˈʃɛ]
глід	hlid	[ˈɦlʲid]
берескле́т	bruslýna	[bereˈsklɛt]
	porá róku	[seˈzɔn]
ка́федра	káfedra	[ˈkɑfedrɐ]
ва́ше	váše	[ˈʋɑʃe]
украї́нець	ukrajínecʹ	[ʊkrɐˈjinet͡sʲ]
Я́ків	Jákiv	/ˈjɑkiu̯/
вона́	voná	[wɔˈnɑ]
воно́	vonó	[wɔˈnɔ]
вони́	voný	[wɔˈnɪ]
горі́лки	horílky	/ɦoˈrilkɪ/
англі́йський	Ánhlija	[ɐnˈɦlʲii̯sʲkei̯]
депута́т	deputát	[depʊˈtɑt]
Ха́рків	Xárkiv	[ˈxɑrkiu̯]
хви́ля	xvýlja	[ˈxʋɪlʲɐ]
хворі́ти	xvoríty	/xvɔˈritɪ/
хворо́ба	xvóryj	/xwoˈrɔbɑ/
		
хло́пець	xlópecʹ	[ˈxlɔpet͡sʲ]
хло́пчик	xlopec	[ˈxlɔpt͡ʃek]
хмарочо́с	xmára	[xmɐrɔˈt͡ʃɔs]
холо́дний	xólod	[xɔˈlɔdnei̯]
хоро́брість	xoróbristʹ	/xɔˈrɔbristʲ/
Христи́на	Xrystýna	[xreˈstɪnɐ]
Христос раждается	Xrystos raždaetsja	[xreˈstɔs ˈrɑʒdɐet͡sʲɐ]
хти́вий	xtývyj	[ˈxtɪu̯ei̯]
хуйло́	xuj	[xʊi̯ˈlɔ]
ху́стка	fustka	[ˈxustkɐ]
ціка́вий	cikávyj	[t͡sʲiˈkɑu̯ei̯]
цілкови́то	cilkovýto	[t͡sʲilkɔˈu̯ɪtɔ]
цап	cap	[ˈt͡sɑp]
цапеня́	capenjá	[t͡sɐpeˈnʲɑ]
цар	car	[ˈt͡sɑr]
цвях	cvjax	[ˈt͡sʲʋʲɑx]
це	ce	[ˈt͡sɛ]
цента́вр	centávr	[t͡senˈtɑu̯r]
центр	centr	[ˈt͡sɛntr]
центра́льний	centrálʹnyj	[t͡senˈtrɑlʲnei̯]
це́рква	cérkva	/ˈt͡sɛrkvɑ/
цига́рка	cyhárka	[t͡seˈɦɑrkɐ]
цига́рок	cyhárok	[t͡seˈɦɑrɔk]
цита́та	cytáta	[t͡seˈtɑtɐ]
цитри́на	cytrýna	[t͡seˈtrɪnɐ]
цуценя́	cucenjá	[t͡sʊt͡seˈnʲɑ]
час	čas	[ˈt͡ʃɑs]
частий	častyj	[ˈt͡ʃɑstei̯]
черво́ний	červónyj	[t͡ʃeˈrwɔnei̯]
череви́к	čerevýk	[t͡ʃereˈu̯ɪk]
чере́мха	čerémuxa	[t͡ʃeˈrɛmxɐ]
четве́р	četvér	[t͡ʃeˈtʋɛr]
чин	čyn	[ˈt͡ʃɪn]
чино́вник	čynóvnyk	[t͡ʃeˈnɔu̯nek]
чи́рва	čýrva	[ˈt͡ʃɪrʋɐ]
число́	čysló	[t͡ʃeˈslɔ]
чита́ти	čytáty	[t͡ʃeˈtɑte]
чолові́к	čolovík	[t͡ʃɔlɔˈu̯ʲik]
чолові́чий	čolovíčyj	[t͡ʃɔlɔˈu̯ʲit͡ʃei̯]
чолові́чий рід	čolovíčyj rid	[t͡ʃɔlɔˈu̯ʲit͡ʃej rʲid]
Чо́рне мо́ре	Čórne móre	[ˈt͡ʃɔrne ˈmɔre]
Чорно́биль	čornóbylʹ	[t͡ʃɔrˈnɔbelʲ]
чоти́ри	čotyry	/t͡ʃoˈtɪrɪ̞/
чума́	čumá	/t͡ʃuˈmɑ/
чу́ти	čúty	[ˈt͡ʃute]
шість	šistʹ	[ˈʃʲisʲtʲ]
шанс	šans	[ˈʃɑns]
шахівни́ця	šaxivnýcja	[ʃɐxʲiu̯ˈnɪt͡sʲɐ]
Швейца́рія	Švajcárija	[ʃʋeijˈt͡sɑrʲijɐ]
Шевче́нко	Ševčénko	[ʃeu̯ˈt͡ʃɛnkɔ]
шестірня́	šestirnjá	[ʃesʲtʲirˈnʲɑ]
шестику́тник	šestykútnyk	[ʃesteˈkutnek]
шип	šyp	[ˈʃɪp]
широ́кий	šyrókyj	[ʃeˈrɔkei̯]
ши́я	šýja	[ˈʃɪjɐ]
шко́ла	škóla	[ˈʃkɔlɐ]
шлях	býta doróha	[ˈʃlʲɑx]
шо́мпол	šómpol	[ˈʃɔmpɔl]
щік	ščik	[ˈʃt͡ʃʲik]
ща́стя	ščástja	/ˈʃt͡ʃɑstʲɑ/
ще	iščé	[ˈʃt͡ʃɛ]
що	ščo	[ʃtʃɔ]
щоб	ščóby	[ˈʃt͡ʃɔb]
щока́	ščoká	[ʃt͡ʃɔˈkɑ]
щока́м	ščokám	[ʃt͡ʃɔˈkɑm]
щока́ми	ščokámy	[ʃt͡ʃɔˈkɑme]
щока́х	ščokáx	[ʃt͡ʃɔˈkɑx]
щоки́	ščoký	[ʃt͡ʃɔˈkɪ]
що́ко	ščóko	[ˈʃt͡ʃɔkɔ]
щоко́ю	ščokóju	[ʃt͡ʃɔˈkɔjʊ]
щоку́	ščokú	[ʃt͡ʃoˈku]
щоці́	ščocí	[ʃt͡ʃoˈt͡sʲi]
юрба́	jurbá	[jʊrˈbɑ]
Ю́щенко	Júščenko	[ˈjuʃt͡ʃenkɔ]
я	jaz	[ˈjɑ]
я не зна́ю	ja ne znáju	[jɐ ne‿ˈznɑjʊ]
я українка	ja ukrajínka	[jɐ ʊkrɐˈjinkɐ]
я́блуко	jábluko	[ˈjɑblʊkɔ]
я́вище	jávyšče	[ˈjɑu̯eʃt͡ʃe]
я́гідка	jahoda	[ˈjɑɦʲidkɐ]
я́года	jáhoda	[ˈjɑɦɔdɐ]
язи́к	jazýk	[jɐˈzɪk]
як спра́ви?	jak správy?	[jɐk ˈsprɑu̯e]
як то кажуть	jak to kažutʹ	[jɐk tɔ ˈkɑʒʊtʲ]
Я́ків	Jákiv	/ˈjɑkiu̯/
я́кість	jakýj	/ˈjɑkistʲ/
Я́на	Jána	[ˈjɑnɐ]
Япо́нія	Japónija	[jɐˈpɔnʲijɐ]
яскра́вий	jaskrávyj	[jɐˈskrɑu̯ei̯]
ячмі́нь	jačmínʹ	[jɐˈt͡ʃmʲinʲ]
ґа́ва	gáva	[ˈɡɑu̯ɐ]
ґа́нок	gánok	[ˈɡɑnɔk]
ґедзь	gedzʹ	[ˈɡɛd͡zʲ]
ґринджо́ли	gryndžóly	[ɡrenˈd͡ʒɔle]
ґу́дзик	gúdzyk	[ˈɡud͡zek]
