ajьce	bulgarian	jajcé	jɐjˈt͡sɛ		IN_WIKTIONARY
ako	bulgarian	akó	əˈkɔ
akъ	bulgarian	jakyj	ˈja̟kʲij	ˈjakʲi	DIFFERENT
akъjь	bulgarian	jakyj	ˈja̟kʲij	ˈjakʲi	DIFFERENT
avě	bulgarian	áve	ˈavɛ
avьnъ	bulgarian	jáven	ˈjavɛn
azъ	bulgarian	az	as	as	SAME
àgnę	bulgarian	ágne	ɐˈɡnɛt͡s		IN_WIKTIONARY
àma	bulgarian	jáma	ˈjamə
ȁgoda	bulgarian	jágoda	ˈjaɡodə		IN_WIKTIONARY
bàjǫ	bulgarian	bája	ˈbajə
bȁba	bulgarian	bába	ˈbabə		IN_WIKTIONARY
berstъ	bulgarian	brjast	ˈbrʲast	ˈbrʲast̪	DIFFERENT
bèrmę	bulgarian	bréme	ˈbrɛmɛ		IN_WIKTIONARY
bèrza	bulgarian	brezá	brɛˈza		IN_WIKTIONARY
bě́lъ	bulgarian	bjal	bʲal		IN_WIKTIONARY
bě̄dà	bulgarian	bedá	bɛˈd̪a
bě̄djǫ̀	bulgarian	bedjá	bɛˈdʲa
bě̑sъ	bulgarian	bjas	[ˈbjas]		CORRECTED
bȇrgъ	bulgarian	brjag	brʲak		IN_WIKTIONARY
bìdlo	bulgarian	bílo	ˈbiɫo̝
bьjǫ	bulgarian	bíja	ˈbijə		IN_WIKTIONARY
bìtva	bulgarian	bitva	ˈbit̪və	ˈbit̪və	SAME
bìčь	bulgarian	bič	bitʃ	bitʃ	SAME
blekъ	bulgarian	blek	blɛk	ˈblɛk	DIFFERENT
blějǫ	bulgarian	bléja	ˈblɛjə
blě̑dъ	bulgarian	bled	blɛt̪	blɛt	DIFFERENT
blě̑skъ	bulgarian	bljásăk	ˈblʲasək
blǫ̑dъ	bulgarian	blud	ˈblut	blud	DIFFERENT
blъxà	bulgarian	bălxá	bɤlˈxa
blьskъ	bulgarian	blắsăk	ˈblisək
blьščǫ	bulgarian	bléštja	ˈblɛʃtʲə
bodàjǫ	bulgarian	bodá	bɔˈdə		IN_WIKTIONARY
bodъlь	bulgarian	bodél	boˈd̪ɛɫ
bogàtъ	bulgarian	bogát	boˈɡat̪
bojǫ sę	bulgarian	bojá se	boˈjɤ sɛ
bojaznь	bulgarian	bojázăn	boˈjazən
bojь	bulgarian	boj	bɔj		IN_WIKTIONARY
bol̹ǫ	bulgarian	bolí	boˈli
bordatъ	bulgarian	bradát	brəˈd̪ɤt̪
bordà	bulgarian	bradá	brəˈda		IN_WIKTIONARY
bordlo	bulgarian	brálo	ˈbraɫo		IN_WIKTIONARY
borna	bulgarian	braná	brəˈna
borzdà	bulgarian	brazdá	brəzˈda		IN_WIKTIONARY
bòlna	bulgarian	blaná	bləˈna
bòlto	bulgarian	bláto	ˈbɫat̪o̝
bor̹ǫ̀	bulgarian	bórja	ˈbɔrʲə
bȍršьno	bulgarian	brašnó	brəʃˈnɔ		IN_WIKTIONARY
bȏgъ	bulgarian	bog	bɔk		IN_WIKTIONARY
bȏlgo	bulgarian	blágo	ˈbɫaɡo
bȏlgъ	bulgarian	blag	blak	blak	SAME
bȏlь	bulgarian	bol	ˈbɔlɛst		IN_WIKTIONARY
bȏrnь	bulgarian	bran	[ˈbran]		CORRECTED
bȏrvъ	bulgarian	brav	ˈbraf	brav	DIFFERENT
bȏrъ	bulgarian	bor	ˈbɔr		IN_WIKTIONARY
bȏsъ	bulgarian	bos	ˈbɔs	bɔs	DIFFERENT
brę̀knǫ	bulgarian	brékna	ˈbrɛknə
bričь	bulgarian	brič	britʃ	britʃ	SAME
brìjǫ	bulgarian	bríja	ˈbrijə
brodjǫ̀	bulgarian	bródja	ˈbrɔdʲə
brȏdъ	bulgarian	brod	brɔt		IN_WIKTIONARY
brusьnica	bulgarian	brusníca	bruˈsnitsə
brutъ	bulgarian	brut	ˈbrut	brut	DIFFERENT
bùr̨a	bulgarian	búrja	ˈburʲə
bytьje	bulgarian	bitié	bitiˈɛ
bỳstrъ	bulgarian	bístăr	ˈbistər
bū̑djǫ	bulgarian	búdja	ˈbudʲə		IN_WIKTIONARY
bū̑čǫ	bulgarian	bučá	buˈtʃa
bъ̏djǫ	bulgarian	bdja	ˈbdja	ˈbdʲa	DIFFERENT
bъrna	bulgarian	bắrna	ˈbɛrnə
bъ̑rz	bulgarian	brăz	ˈbrɤs
bьčelà	bulgarian	pčelá	ptʃɛˈla		IN_WIKTIONARY
cě̑djǫ	bulgarian	cedjá	t͡sɛˈdʲa
cě̄nà	bulgarian	cená	t͡sɛˈna		IN_WIKTIONARY
cěn̹ǫ	bulgarian	cenjá	t͡sɛˈnʲa
cě̑lъ	bulgarian	cjal	t͡sʲaɫ	ˈt͡sʲaɫ	DIFFERENT
cě̑vь	bulgarian	cev	t͡sɛf	t͡sɛv	DIFFERENT
da	bulgarian	da	d̪a		IN_WIKTIONARY
dȃrъ	bulgarian	dar	dar		IN_WIKTIONARY
debelъ	bulgarian	debél	dɛˈbɛl		IN_WIKTIONARY
deltò	bulgarian	dletó	dlɛˈtɔ		IN_WIKTIONARY
desętъ	bulgarian	deséti	dɛˈsɛti
devętъ	bulgarian	devéti	dɛˈvɛti
dérnъ	bulgarian	drjan	drʲan	drʲan	SAME
děl̹ǫ	bulgarian	deljá	dɛˈlʲɤ		IN_WIKTIONARY
dětę	bulgarian	deté	dɛˈtɛ		IN_WIKTIONARY
děti	bulgarian	déti	ˈdɛti
děvìca	bulgarian	devíca	dɛˈvitsə		IN_WIKTIONARY
dě̀lo	bulgarian	délo	ˈdɛlo		IN_WIKTIONARY
dě̀va	bulgarian	déva	ˈd̪ɛvə
dě̀verь	bulgarian	déver	ˈdɛvɛr
dȅsętь	bulgarian	déset	dɛˈsɛti		IN_WIKTIONARY
dȅsnъ	bulgarian	désen	ˈdɛsɛn		IN_WIKTIONARY
dȅvętь	bulgarian	dévet	dɛˈvɛti		IN_WIKTIONARY
dȇrvo	bulgarian	derévo	dɛˈrɛvo
dir̹ǫ	bulgarian	dírja	ˈdirʲə
divьnъ	bulgarian	díven	ˈdivɛn
do	bulgarian	do	dɔ	dɔ	SAME
doba	bulgarian	dóba	dɔˈba
dobrъ	bulgarian	dobắr	dɔpˈrɔ
dojidlo	bulgarian	dójlo	ˈd̪ɔjɫo
dȏjǫ	bulgarian	dojá	dɔˈja
doltò	bulgarian	dlató	dlɐˈtɔ
dolъ	bulgarian	dol	dɔl		IN_WIKTIONARY
domovъ	bulgarian	domoví	dɔmuˈvi
dòlnь	bulgarian	dlan	dlan		IN_WIKTIONARY
dȏmъ	bulgarian	dom	dɔm		IN_WIKTIONARY
dȏrgъ	bulgarian	drag	drak	drak	SAME
dǭgà	bulgarian	dăgá	dəˈɡa
dǫ̑bъ	bulgarian	dăb	dɤp
drebъ	bulgarian	dreb	drɛp	drɛb	DIFFERENT
drebьnъ	bulgarian	drében	ˈdrɛbɛn		IN_WIKTIONARY
drěml̹ǫ̀	bulgarian	drémja	ˈdrɛmʲə
drobl̹ǫ	bulgarian	drobjá	droˈbʲa
drobъ	bulgarian	drob	drɔp		IN_WIKTIONARY
drobь	bulgarian	drob	drɔp		IN_WIKTIONARY
drozdъ	bulgarian	drozd	drɔst	drozd	DIFFERENT
dročǫ	bulgarian	dróča	ˈdrɔtʃə
družìna	bulgarian	družína	druˈʒinə
drȗgъ	bulgarian	drug	druk		IN_WIKTIONARY
drъ̏vo	bulgarian	dărvó	d̪ˈirvɔ
duplò	bulgarian	dúplo	ˈduplo
duplь	bulgarian	dúpli	ˈdupli
dujǫ sę	bulgarian	dúja se	ˈdujə sɛ
dȗxъ	bulgarian	dux	dux	dux	SAME
dva	bulgarian	dva	ˈftɔri		IN_WIKTIONARY
dvòrъ	bulgarian	dvor	[ˈdvɔr]		CORRECTED
dỳmъ	bulgarian	dim	dim	dim	SAME
dāvl̹ǫ̀	bulgarian	dávja	ˈd̪avʲə
dīvl̹ǫ	bulgarian	divjá	diˈvʲa
dūšà	bulgarian	dušá	duˈʃa
dъnò	bulgarian	dắno	ˈd̪ɔno
dъva	bulgarian	dva	ˈftɔri		IN_WIKTIONARY
dъxъ	bulgarian	dăx	dɤx
dъždžь	bulgarian	dăžd	ˈdɤʃt
dъ̑lgъ	bulgarian	dălg	dɤlk
dьly	bulgarian	délva	ˈd̪ɛɫvə
dьnьsь	bulgarian	dnes	[ˈdnɛs]		CORRECTED
derǫ	bulgarian	derá	dɛˈra
dьrzъkъ	bulgarian	dắrzăk	dərsəˈkra
dьržǫ	bulgarian	dăržá	dərˈʒa
dь̀lgъ	bulgarian	dắlăg	diˈlɔk
dь̑nь	bulgarian	den	dɛn		IN_WIKTIONARY
erębica	bulgarian	érebica	ˈɛrɛbitsə
ese	bulgarian	esé	ɛˈsɛ
estь	bulgarian	e	ɛ		IN_WIKTIONARY
eto	bulgarian	éto	ˈɛt̪o̝
ešče	bulgarian	ešte	ˈɛʃtɛ	ˈɛʃtɛ	SAME
ežь	bulgarian	ež	ɛʃ	ɛʒ	DIFFERENT
ěrę	bulgarian	járe	ˈjarɛ
ěrina	bulgarian	járina	ˈjarinə
ěrostь	bulgarian	járost	ˈjarost
ěrъka	bulgarian	járka	ˈjarkə
ěrьcь	bulgarian	járec	ˈjarɛts
ězda	bulgarian	jazdá	jəzˈda
ě̀snъ	bulgarian	jásen	ˈjasɛn
ě̀to	bulgarian	játo	ˈjato
ě̀zva	bulgarian	jázva	ˈjazvə
ȅsenь	bulgarian	jésen	ˈjɛsɛn
ȇ̌dъ	bulgarian	jad	[ˈjat]		CORRECTED
ędrъ	bulgarian	édăr	ˈɛdər
ęzỳkъ	bulgarian	ezík	ɛˈzik
ęčǫ	bulgarian	ečá	ɛˈtʃa
gadajǫ	bulgarian	gadája	ɡɐˈdajə
gàsnǫ	bulgarian	gásna	ˈɡasnə
gàdъ	bulgarian	gad	ɡat	ɡat	SAME
gàžǫ	bulgarian	gázja	ˈɡazʲə
glàdъkъ	bulgarian	gládăk	ˈɡlatək
glìna	bulgarian	glína	ˈɡlinə
glìva	bulgarian	gliva	ɡliva	ɡliva	SAME
globa	bulgarian	glóba	ˈɡlɔbə
globl̹ǫ	bulgarian	globjá	ɡɫoˈbʲɤ		IN_WIKTIONARY
glota	bulgarian	glóta	ˈɡlɔtə
glògъ	bulgarian	glog	ɡlɔk	ɡlɔk	SAME
glȗxъ	bulgarian	glux	ˈɡlux	ɡlux	DIFFERENT
glъtati	bulgarian	gắltam	ˈɡʲaltam
gnȅstǫ	bulgarian	gnetá	ɡnɛˈt̪ɤ
gně̀vъ	bulgarian	gnjav	ɡnʲaf		IN_WIKTIONARY
gně̄zdò	bulgarian	gnezdó	ɡnɛzˈdɔ
gnȏjь	bulgarian	gnoj	ˈɡnɔj	ˈɡnɔj	SAME
gnušǫ sę	bulgarian	gnusjá se	ɡnuˈsʲɤ sɛ
gnusьnъ	bulgarian	gnúsăn	ˈɡnusən
gńilъ	bulgarian	gnil 	ɡniɫ no	ɡniɫ	DIFFERENT
gńìda	bulgarian	gnída	ˈɡnid̪ə
gńìjǫ	bulgarian	gníja	ˈɡniːjə
godina	bulgarian	godína	ɡɔˈdinə		IN_WIKTIONARY
godьnъ	bulgarian	góden	ˈɡɔdɛn
gojǫ	bulgarian	gojá	ɡoˈja
golěmъ	bulgarian	goljám	ɡoˈʎam		IN_WIKTIONARY
golota	bulgarian	golotá	ɡoloˈtə
golvà	bulgarian	glavá	ɡləˈva		IN_WIKTIONARY
gon̹ǫ̀	bulgarian	gónja	ˈɡɔnʲə
gorà	bulgarian	gorá	ɡoˈra		IN_WIKTIONARY
gor̹ǫ	bulgarian	gorjá	ɡoˈrʲa
gorьkъ	bulgarian	górăk	ˈɡɔrək
gospodinъ	bulgarian	gospodín	ɡospoˈdin		IN_WIKTIONARY
gospodь	bulgarian	góspod	ˈɡɔspot
gově̀jǫ	bulgarian	govéja	ɡoˈvɛjə
govę̀do	bulgarian	govédo	ɡoˈvɛd̪o̝
govor̹ǫ	bulgarian	govórja	ɡoˈvɔrʲə		IN_WIKTIONARY
govorъ	bulgarian	góvor	ˈɡɔvor
govьnò	bulgarian	govnó	ɡovˈnɔ
gòlъ	bulgarian	gol	ɡol	ɡɔl	DIFFERENT
gòrxъ	bulgarian	grax	ˈɡrax	ɡrax	DIFFERENT
gȏldъ	bulgarian	glad	ˈɡlat	ɡlat	DIFFERENT
gȏlsъ	bulgarian	glas	[ˈɡlas]		CORRECTED
gȏrdъ	bulgarian	grad	[ˈɡrat]		CORRECTED
gȏstь	bulgarian	gost	ɡost̪	ˌɡɔst̪	DIFFERENT
gǫgnivъ	bulgarian	găgnív	ɡɐɡˈnif
gǫžь	bulgarian	găž	ˈɡɤʃ
gǫ̀ba	bulgarian	gắba	ɡəbɐ
gǫ̑stъ	bulgarian	găst	ˈɡɤst
gramada	bulgarian	gramáda	ɡrəˈmadə
gràbl̹ǫ	bulgarian	grábja	ˈɡrabʲə		IN_WIKTIONARY
gràdъ	bulgarian	grad	[ˈɡrat]		CORRECTED
grebenь	bulgarian	grében	ˈɡrɛbɛn		IN_WIKTIONARY
grebǫ	bulgarian	grebá	ɡrɛˈbɤ		IN_WIKTIONARY
grějǫ	bulgarian	gréja	ˈɡrɛjə
grě́xъ	bulgarian	grjach	ˈɡrʲax	ɡrʲatʃ	DIFFERENT
grę̄dà	bulgarian	gredá	ɡrɛˈd̪ɤ
grivьna	bulgarian	grívna	ˈɡrivnə
grìva	bulgarian	gríva	ˈɡrivə
grobъ	bulgarian	grob	[ˈɡrɔp]		CORRECTED
gromada	bulgarian	gromáda	ɡroˈmad̪ə
grozdьje	bulgarian	grózde	ˈɡrɔzdɛ
grožǫ	bulgarian	grozjá	ɡroˈzʲa
grozьnъ	bulgarian	grózen	ˈɡrɔzɛn
gròzdъ	bulgarian	grozd	[ˈɡrost]		CORRECTED
grǫ̑dь	bulgarian	grăd	ˈɡrɤt
gry̑zǫ	bulgarian	grizá	ɡriˈza
grьml̹ǫ	bulgarian	gărmjá	ɡɤrˈmʲa
gubl̹ǫ	bulgarian	gúbja	ˈɡubʲə		IN_WIKTIONARY
gumьnò	bulgarian	gúmno	ˈɡumno
gvě̄zdà	bulgarian	zvezdá	zvɛzˈda		IN_WIKTIONARY
gvozdi	bulgarian	gvózdej	ˈɡvɔzdɛj		IN_WIKTIONARY
gyža	bulgarian	gíža	ˈɡʲiʒə
gāšǫ	bulgarian	gasjá	ɡɐˈsʲa
gъ̀rdlo	bulgarian	gắrlo	ˈɡrɛ
i	bulgarian	i	i		IN_WIKTIONARY
jùgъ	bulgarian	jug	juk		IN_WIKTIONARY
jьgràjǫ	bulgarian	igrája	iˈɡrajə
jьgъlà	bulgarian	iglá	iˈɡla
jьmę	bulgarian	imé	iˈmɛ
jь̑go	bulgarian	ígo	ˈiɡo		IN_WIKTIONARY
kal̹ǫ	bulgarian	kaljá	kɐˈlʲa
kasàjǫ sę	bulgarian	kasáe se	kaˈsaɛ sɛ
kažǫ	bulgarian	káža	ˈkaʒə		IN_WIKTIONARY
kašl̹ǫ	bulgarian	kášlja	ˈkaʃlʲə
kašьl̹ǫ	bulgarian	kášlja	ˈkaʃlʲə
kàjǫ sę	bulgarian	kája se	ˈkajə sɛ
kȃlъ	bulgarian	kal	kaɫ	kal	DIFFERENT
kladǫ	bulgarian	kladá	kɫɐˈd̪ɤ		IN_WIKTIONARY
klějь	bulgarian	klej	klɛj	ˈklɛj	DIFFERENT
klěšča	bulgarian	kléšti	ˈklɛʃti		IN_WIKTIONARY
klęčǫ	bulgarian	klečá	klɛˈtʃa
klokotjǫ	bulgarian	klokòtati	kɫoˈkɔt̪ət̪i
kl̨účь	bulgarian	ključ	ˈklʲu̟t͡ʃ		IN_WIKTIONARY
kolě̀no	bulgarian	koljáno	koˈlʲano̝
kol̹ǫ̀	bulgarian	kólja	ˈkɔlʲə
koltjǫ	bulgarian	klátja	ˈkɫatʲə
kopa	bulgarian	kopá	koˈpa
kopajǫ	bulgarian	kopája	koˈpajə
koprъ	bulgarian	kópăr	ˈkɔpər
kopьje	bulgarian	kópie	ˈkɔpiɛ
korà	bulgarian	korá	koˈra		IN_WIKTIONARY
korenь	bulgarian	kóren	ˈkɔrɛn		IN_WIKTIONARY
korica	bulgarian	koríca	koˈritsə
kor̹ǫ	bulgarian	korjá	koˈrʲɤ		IN_WIKTIONARY
kortъkъ	bulgarian	krátăk	ˈkratək
korỳto	bulgarian	koríto	koˈrito		IN_WIKTIONARY
korъ	bulgarian	kor	ˈkɔr	ˌkɔr	DIFFERENT
kosà	bulgarian	kosá	koˈsa		IN_WIKTIONARY
kosmъ	bulgarian	kósăm	ˈkɔsəm
kȍtjǫ	bulgarian	kótja	ˈkɔtʲə
kovǫ	bulgarian	ková	koˈvɤ		IN_WIKTIONARY
kozà	bulgarian	kozá	koˈza		IN_WIKTIONARY
kozьlъ	bulgarian	kozél	koˈzɛɫ		IN_WIKTIONARY
kòlda	bulgarian	kláda	ˈkɫad̪ə
kòlъ	bulgarian	kol	[ˈkɔl]		CORRECTED
kòn̨ь	bulgarian	kon	kɔn		IN_WIKTIONARY
kòrsta	bulgarian	krásta	ˈkrast̪ə
kòrva	bulgarian	kráva	ˈkravə		IN_WIKTIONARY
kòšь	bulgarian	koš	kɔʃ		IN_WIKTIONARY
kòža	bulgarian	kóža	ˈkɔʒə		IN_WIKTIONARY
kȏlsъ	bulgarian	klas	klas	klas	SAME
kȏstь	bulgarian	kost	kɔst		IN_WIKTIONARY
kȏsъ	bulgarian	kos	ˈkɔs	ˈkɔs	SAME
kǫdě	bulgarian	kădé	ˈkʲa
kǫpina	bulgarian	kăpína	kɤˈpinə
kǫtja	bulgarian	kắšta	ˈkʃta
kǫ́tъ	bulgarian	kăt	ˈkɤt̪
kǫ̑sъ	bulgarian	kăs	ˈkɤs
krajь	bulgarian	kraj	kraj		IN_WIKTIONARY
kradǫ	bulgarian	kradá	kraˈdə		IN_WIKTIONARY
krěpъkъ	bulgarian	krépăk	ˈkrɛpək
krě̀slo	bulgarian	kresló	krɛˈsɫɔ
krojǫ	bulgarian	krojá	kroˈja
krotъkъ	bulgarian	krótăk	ˈkrɔtək
krȍsno	bulgarian	krosnó	kroˈsnɔ
krǫglъ	bulgarian	krắgăl	kriˈɡɤɫ
krǫpъ	bulgarian	krăp	ˈkrɤp
krǫ̑gъ	bulgarian	krăg	krɤk
krupьnъ	bulgarian	krúpen	ˈkrupɛn
kruxъ	bulgarian	krux	ˈkrux	krux	DIFFERENT
kry	bulgarian	krăv	ˈkrɤf
krỳjǫ	bulgarian	kríja	ˈkrijə
krīdlò	bulgarian	kriló	kriˈlɔ		IN_WIKTIONARY
krъvьnъ	bulgarian	krắven	ˈkrivɛn
kuka	bulgarian	kúka	ˈkukə
kurъ	bulgarian	kur	kur		IN_WIKTIONARY
kuzn̨a	bulgarian	kúznja	ˈkuznʲə
kùpъ	bulgarian	kup	kup	kup	SAME
kvȃsъ	bulgarian	kvas	[ˈkvas]		CORRECTED
kvě̑tъ	bulgarian	cvjat	t͡svʲat		IN_WIKTIONARY
kydnǫ	bulgarian	kína	ˈkʲinə
kypl̹ǫ	bulgarian	kipjá	kiˈpʲa
kyprъ	bulgarian	kípăr	ˈkipər
kỳsajǫ	bulgarian	kísel	ˈkisɛɫ
kỳla	bulgarian	kíla	ˈkʲilə
kadjǫ	bulgarian	kadjá	kəˈdʲa
kъ	bulgarian	kăm	ˈkɤm
kъde	bulgarian	gde	ɡdɛ	ɡdɛ	SAME
kъjь	bulgarian	koj	[ˈkɔj]		CORRECTED
kъn	bulgarian	kăm	ˈkɤm
kъrkati	bulgarian	kắkati	kəˈkati
kъrma	bulgarian	kărmá	kɤrˈma
kъsьnъ	bulgarian	kắsen	ˈkasni
kъ̀rpa	bulgarian	kắrpa	ˈkarpa
làjǫ	bulgarian	lája	ˈlajə
làpa	bulgarian	lápa	ˈlapə
làska	bulgarian	láska	ˈlaskə
laskajǫ	bulgarian	laskája	lɐˈskajə
làžǫ	bulgarian	lázja	ˈɫazʲə
lȅtjǫ	bulgarian	letjá	lɛˈtʲɤ		IN_WIKTIONARY
ležǫ	bulgarian	ležá	lɛˈʒɤ		IN_WIKTIONARY
lěnìvъ	bulgarian	lenív	lɛˈnif
lěpl̹ǫ̀	bulgarian	lepjá	lɛˈpʲa
lě̀to	bulgarian	ljáto	ˈlʲat̪o̝
lě̑sъ	bulgarian	les	lɛs		IN_WIKTIONARY
lě̑vъ	bulgarian	ljav	lʲaf	lʲav	DIFFERENT
lě̑xà	bulgarian	lehá	lɛˈxa
lȇdъ	bulgarian	led	lɛt		IN_WIKTIONARY
lisa	bulgarian	lísa	ˈlisə
lisìca	bulgarian	lisíca	lʲiˈsit͡sə		IN_WIKTIONARY
lějǫ	bulgarian	léja	ˈlɛjə
loky	bulgarian	lókva	ˈlɔkvə
loml̹ǫ̀	bulgarian	lomjá	loˈmʲa
lonò	bulgarian	lóno	ˈlɔno
lopàta	bulgarian	lopáta	loˈpatə		IN_WIKTIONARY
lȍvl̹ǫ	bulgarian	lovjá	loˈvʲa
lozà	bulgarian	lozá	loˈza
lošь	bulgarian	loš	lɔʃ	ɫəʃ	DIFFERENT
lože	bulgarian	lóže	ˈlɔʒɛ
lȏjь	bulgarian	loj	lɔj	lɔj	SAME
lȏvъ	bulgarian	lov	[ˈlɔf]		CORRECTED
lǫ̑gъ	bulgarian	lăg	lɤk
lǫ̑kъ	bulgarian	lăk	ˈlɤk
ludъ	bulgarian	lud	lut	lut	SAME
lunà	bulgarian	luná	luˈna		IN_WIKTIONARY
luspa	bulgarian	ljúspa	ˈlʲuspə
luščǫ	bulgarian	ljúštja	ˈlʲuʃtʲə
lysъ	bulgarian	lis	[ˈlis]		CORRECTED
līcè	bulgarian	licé	liˈt͡sɛ		IN_WIKTIONARY
līžǫ̀	bulgarian	líža	ˈliʒə		IN_WIKTIONARY
lǭkà	bulgarian	lăká	ləˈka
l̨uby	bulgarian	ljubóv	lʲuˈbɔf		IN_WIKTIONARY
l̨utiti sę	bulgarian	l. se	l
l̨utъ	bulgarian	ljut	lʲut	ˈlʲut̪	DIFFERENT
l̨ūbl̹ǫ̀	bulgarian	ljúbja	ˈlʲubʲə
lъžǫ̀	bulgarian	lắža	ləˈʒa
lъža	bulgarian	lăžá	ˈlɤʒə
lьgъkъ	bulgarian	lek	ˈlɛkər		IN_WIKTIONARY
lьněnъ	bulgarian	lénen	ˈlɛnɛn
lь̑nъ	bulgarian	len	ˈlɛn	lʲɛn	DIFFERENT
malъkъ	bulgarian	málăk	ˈmaɫək
mara	bulgarian	mára	ˈmarə
màkъ	bulgarian	mak	mak	ˈmakə	DIFFERENT
màlъ	bulgarian	mal	maɫ	ˈmaɫ	DIFFERENT
màslo	bulgarian	máslo	ˈmasɫo̝
mȃstь	bulgarian	másti	ˈmasti
medjà	bulgarian	meždá	mɛʒˈd̪a
medju	bulgarian	meždú	mɛʒˈdu
melkò	bulgarian	mljáko	ˈmlʲa̟ko̝
mel̹ǫ̀	bulgarian	mélja	ˈmɛlʲə
mьlzǫ	bulgarian	mălzjá	mɤlˈzʲa
mene	bulgarian	méne	ˈmɛnɛ		IN_WIKTIONARY
mȅtǫ	bulgarian	metá	mɛˈt̪ɤ		IN_WIKTIONARY
mèrža	bulgarian	mréža	ˈmrɛʒə
měn̹ǫ	bulgarian	menjá	mɛˈnʲa
mě̀dь	bulgarian	med	mɛt		IN_WIKTIONARY
mě̀r̹ǫ	bulgarian	mérja	ˈmɛrʲə
mě̀sęcь	bulgarian	mésec	ˈmɛsɛt͡s		IN_WIKTIONARY
mě̀sto	bulgarian	mjásto	ˈmʲasto		IN_WIKTIONARY
mě̄zgà	bulgarian	măzgá	mɤˈzɡa
mě̑šǫ̀	bulgarian	mésja	ˈmɛsʲə
mȇdъ	bulgarian	med	mɛt		IN_WIKTIONARY
mękъkъ	bulgarian	mek	[ˈmɛk]		CORRECTED
mьnǫ	bulgarian	mắna	mɛn
mę̑so	bulgarian	mesó	mɛˈsɔ		IN_WIKTIONARY
mirъ	bulgarian	mir	ˈmir		IN_WIKTIONARY
mitě	bulgarian	mitó	miˈtɔ
mižǫ	bulgarian	mižá	miˈʒa
mìlъ	bulgarian	mil	miɫ	miɫ	SAME
mȋgъ	bulgarian	mȋg	mîk
mlinъ	bulgarian	mlin	[ˈmlin]		CORRECTED
mogǫ	bulgarian	móga	ˈmɔɡə		IN_WIKTIONARY
mogtь	bulgarian	mošt	mɔʃt	ˌmɔʃt̪	DIFFERENT
mojь	bulgarian	moj	mɔj		IN_WIKTIONARY
mokrъ	bulgarian	mókăr	ˈmɔkər
moldъ	bulgarian	mlad	mlat		IN_WIKTIONARY
moltjǫ	bulgarian	mlátja	ˈmɫatʲə
monisto	bulgarian	manísto	mɐˈnist̪o̝
morà	bulgarian	morá	moˈra
morvi	bulgarian	mrávka	ˈmravkə		IN_WIKTIONARY
morъ	bulgarian	mor	mɔr	mɔr	SAME
motajǫ	bulgarian	motája	moˈt̪ajə
motyka	bulgarian	motíka	moˈtikə
mòrzъ	bulgarian	mraz	mras		IN_WIKTIONARY
mȍr̨e	bulgarian	moré	moˈrɛ		IN_WIKTIONARY
mȏrkъ	bulgarian	mrak	mrak		IN_WIKTIONARY
mȏstъ	bulgarian	most	mɔst		IN_WIKTIONARY
mȏzgъ	bulgarian	mózăk	ˈmɔsək
mǫ̀ka	bulgarian	mắka	ˈmŋka
mǫ̀čǫ	bulgarian	mắča	mɛtʃə
mǫ́drъ	bulgarian	mắdăr	mid̪ˈɤr
mǭtjǫ	bulgarian	mắtja	mɛˈtjɤ
mǫ̑žь	bulgarian	măž	mɤʃ
mùxa	bulgarian	muxá	muˈxa
my	bulgarian	mi	mi		IN_WIKTIONARY
myto	bulgarian	míto	ˈmit̪o̝
mỳjǫ	bulgarian	míja	ˈmijə
mъknǫ	bulgarian	mắkna	ˈmɛknə
mъldni	bulgarian	mắlnija	mɛɫnijə
mъlva	bulgarian	mălvá	mɐɫˈvɤ
mъlvl̹ǫ	bulgarian	mălvjá	mɐɫˈvʲa
mъnogъ	bulgarian	mnógo	ˈmnɔɡo
mъrmъr̹ǫ	bulgarian	mărmórja	mɤrˈmɔrʲə
mъxъ	bulgarian	măx	mɤx
mьlčǫ	bulgarian	mălčá	mɐlˈt͡ʃa
mьrznǫ	bulgarian	mrắzna	ˈmrɛznə
mьstjǫ	bulgarian	măstjá	mɤˈstʲa
mьčьta	bulgarian	mečtá	mɛtʃˈt̪a		IN_WIKTIONARY
na	bulgarian	na	na		IN_WIKTIONARY
nadъ	bulgarian	nad	nat	nat	SAME
náglъ	bulgarian	nágăl	ˈnaɡʲəl
ne	bulgarian	ne	nɛ		IN_WIKTIONARY
nedǫ̀gъ	bulgarian	nedắg	nɛt
nejęsytь	bulgarian	nésit	ˈnɛsit
nevě̀sta	bulgarian	nevésta	nɛˈvɛst̪ə
nevodъ	bulgarian	névod	ˈnɛvot
neže	bulgarian	néže	ˈnɛʒɛ
nȅbo	bulgarian	nebé	nɛˈbɛ		IN_WIKTIONARY
ni	bulgarian	ni	ni		IN_WIKTIONARY
nicь	bulgarian	nícọm	niitsom
niknǫ	bulgarian	níkna	ˈniknə
nìščь	bulgarian	ništ	niʃt̪	niʃt̪	SAME
nogà	bulgarian	nogá	noˈɡa		IN_WIKTIONARY
nogъtь	bulgarian	nókăt	ˈnɔkət
nošǫ̀	bulgarian	nósja	ˈnɔsʲə
novákъ	bulgarian	novák	noˈvak
nòvъ	bulgarian	nov	nɔf		IN_WIKTIONARY
nòžь	bulgarian	nož	nɔʃ	nɔʃ	SAME
nȏktь	bulgarian	nošt	nɔʃt		IN_WIKTIONARY
nȏsъ	bulgarian	nos	nɔs		IN_WIKTIONARY
nāròdъ	bulgarian	naród	nɐˈrɔt̪
nъ	bulgarian	nă	nɤ
ob	bulgarian	o	ɔ	ˌɔ	DIFFERENT
obětjajǫ	bulgarian	obeštája	o̝bɛˈʃt̪ajə		IN_WIKTIONARY
obolkъ	bulgarian	óblak	ˈɔblək
obujǫ	bulgarian	obúja	oˈbujə
obьlъ	bulgarian	óbăl	ˈɔbəɫ
obьtjь	bulgarian	obšt	ˈɔpʃt	o̝bʃt̪	DIFFERENT
okъnò	bulgarian	oknó	oˈknɔ
oldi	bulgarian	ládija	ˈladijə
olni	bulgarian	láni	ˈlani
or̹ǫ	bulgarian	orá	oˈra
orbòta	bulgarian	rábota	ˈrabotə
orbъ	bulgarian	rab	rab		IN_WIKTIONARY
orě̀xъ	bulgarian	órex	ˈɔɾɛx
orkỳta	bulgarian	rakíta	rɐˈkʲit̪ə
orǫdьje	bulgarian	orắdie	ˈɔrɛdiɛ
orstǫ	bulgarian	rastá	rɐˈsta
ortь	bulgarian	rat	rat	ˈrat̪	DIFFERENT
orz	bulgarian	raz-	ras	raz	DIFFERENT
orь̀lъ	bulgarian	orél	oˈrɛl		IN_WIKTIONARY
osà	bulgarian	osá	oˈsa		IN_WIKTIONARY
osmъ	bulgarian	ósmi	ˈɔsmi
osnòvā	bulgarian	osnóva	osˈnɔvə
ostrovъ	bulgarian	óstrov	ˈɔstrof
ostrъ	bulgarian	óstăr	ˈɔstər
ostь̀nъ	bulgarian	ostén	oˈst̪ɛn
ot	bulgarian	ot	ɔt̪		IN_WIKTIONARY
otrokъ	bulgarian	otrók	otˈrɔk
otvor̹ǫ̀	bulgarian	otvórja	ot̪ˈvɔrʲə		IN_WIKTIONARY
otъ	bulgarian	ot	ɔt̪		IN_WIKTIONARY
otъvor̹ǫ̀	bulgarian	otvórja	ot̪ˈvɔrʲə		IN_WIKTIONARY
ovъ	bulgarian	óvi	ˈɔvi
ovьcà	bulgarian	ovcá	ofˈt͡sa		IN_WIKTIONARY
ovьnъ	bulgarian	ovén	oˈvɛn		IN_WIKTIONARY
ovь̀sъ	bulgarian	ovés	oˈvɛs
òdrъ	bulgarian	ódăr	ˈɔdər
ògn'ь	bulgarian	ógăn	ˈɔɡən
òlkomъ	bulgarian	lákom	ˈlakom
òlkomъjь	bulgarian	lákom	ˈlakom
òlni	bulgarian	álne	ˈalnɛ
òlčьnъ	bulgarian	álčen	ˈaltʃɛn		IN_WIKTIONARY
òrdlo	bulgarian	rálo	ˈraɫo̝
òrkъ	bulgarian	rak	rak	rak	SAME
òrtajь	bulgarian	rátaj	ˈrat̪əj
ȍko	bulgarian	okó	oˈkɔ		IN_WIKTIONARY
ȍlovo	bulgarian	élavo	ˈɛləvo
ȏsь	bulgarian	os	[ˈɔs]		CORRECTED
ǫ̀zlъ	bulgarian	vắzel	ˈvɛzɛɫ
ǫ̑gъlъ	bulgarian	ắgăl	
palъka	bulgarian	pálka	ˈpalkə		IN_WIKTIONARY
palьcь	bulgarian	pálec	ˈpalɛts		IN_WIKTIONARY
pasǫ	bulgarian	pasá	pɐˈsɤ		IN_WIKTIONARY
pažǫ	bulgarian	pázja	ˈpazʲə
pàmętь	bulgarian	pámet	ˈpamɛt̪
pàra	bulgarian	pára	ˈparə
pȅkǫ	bulgarian	peká	pɛˈkɤ		IN_WIKTIONARY
perdъ	bulgarian	pred	prɛt̪	prɛt	DIFFERENT
perkъ	bulgarian	prjak	prʲak	prʲak	SAME
però	bulgarian	peró	pɛˈrɔ
pèlva	bulgarian	pljáva	ˈplʲavə
pěsъ̀kъ	bulgarian	pjásăk	ˈpʲasək
pojǫ	bulgarian	pojá	poˈja
pěšь	bulgarian	peš	ˈpɛʃ	pɛʃ	DIFFERENT
pě̀na	bulgarian	pjána	ˈpʲanə
pȇktь	bulgarian	pešt	[ˈpɛʃt]		CORRECTED
pę̑tь	bulgarian	pet	ˈpɛt̪i		IN_WIKTIONARY
pętà	bulgarian	petá	pɛˈt̪ɤ
pętъ	bulgarian	petí	pɛˈt̪i
pьjǫ	bulgarian	píja	ˈpijə		IN_WIKTIONARY
pȋvo	bulgarian	pívo	ˈpivo̝
pjujǫ	bulgarian	pljúja	ˈplʲujə
plàčǫ	bulgarian	pláča	ˈpɫatʃə
plàvl̹ǫ	bulgarian	plávja	ˈpɫavʲə
plástъ	bulgarian	plast	plast	plast	SAME
pletǫ	bulgarian	pletá	plɛˈt̪ɤ		IN_WIKTIONARY
pletjè	bulgarian	pléšti	ˈplɛʃt̪i
plěsnь	bulgarian	plésen	ˈplɛsɛn
ploskъ	bulgarian	plósăk	ˈplɔsək
podъ	bulgarian	pod	ˈpɔt	pɔt	DIFFERENT
pokòjь	bulgarian	pokój	poˈkɔj
polìca	bulgarian	políca	poˈlitsə
poltьnò	bulgarian	platnó	plɐtˈno
polšǫ	bulgarian	pláša	ˈpɫaʃə		IN_WIKTIONARY
polьdza	bulgarian	pólza	ˈpɔɫzə
porà	bulgarian	póra	ˈpɔrə
por̹ǫ	bulgarian	pórja	ˈpɔrʲə
posětjǫ	bulgarian	posetjá	po̝sɛˈtʲɤ		IN_WIKTIONARY
pozdьnъ	bulgarian	pózden	ˈpɔzdɛn
pòlxъ	bulgarian	plax	plax	plax	SAME
pòrgъ	bulgarian	prag	prak	prak	SAME
pȍjāsъ	bulgarian	pójas	ˈpɔjəs
pȍl̨e	bulgarian	polé	poˈlɛ
pȍrsę	bulgarian	prasé	prəˈsɛ		IN_WIKTIONARY
pȏlzъ	bulgarian	plaz	plas	plaz	DIFFERENT
pȏrxъ	bulgarian	prax	prax	prax	SAME
pȏtъ	bulgarian	pot	[ˈpɔt]		CORRECTED
pǫdjǫ	bulgarian	pắdja	ˈpɛdja
pǫ́tь	bulgarian	păt	pɤt̪
pràvъ	bulgarian	prav	ˈpraf	prav	DIFFERENT
prędǫ	bulgarian	predá	prɛˈd̪ɤ		IN_WIKTIONARY
pri	bulgarian	pri	pri	pri	SAME
prijatelь	bulgarian	prijátel	priˈjatɛl		IN_WIKTIONARY
prídъ	bulgarian	prídăt	ˈprit̪ət̪
prosějǫ	bulgarian	proséja	proˈsɛjə
prošǫ̀	bulgarian	prósja	ˈprɔsʲə
prostьrǫ	bulgarian	prostrá	proˈst̪rɤ		IN_WIKTIONARY
prȏstъ	bulgarian	prost	[ˈprɔst]		CORRECTED
prъskǫ	bulgarian	prắska	ˈprɤskə
pȗstъ	bulgarian	pust	pust̪	pust	DIFFERENT
pāl̹ǫ̀	bulgarian	pálja	ˈpalʲə
pъtìca	bulgarian	ptíca	ˈptitsə		IN_WIKTIONARY
perǫ	bulgarian	perá	pɛˈrɤ
pьrvъ	bulgarian	părvi	ˈpɔrvi
pišǫ̀	bulgarian	píša	ˈpiʃə		IN_WIKTIONARY
pь̀lnъ	bulgarian	pắlen	pəˈlɛn
pь̀rstъ	bulgarian	prăst	ˈprɤst
pь̀strъ	bulgarian	pắstăr	ˈpɛstər
pь̑nь	bulgarian	păn	pɤn
pь̑rstь	bulgarian	prăst	ˈprɤst
radjǫ	bulgarian	radjá	rɐˈdʲa
rebrò	bulgarian	rebró	rɛˈbrɔ
rekǫ	bulgarian	reká	rɛˈkɤ		IN_WIKTIONARY
rě̀jǫ	bulgarian	réja	ˈrɛjə
rě̄kà	bulgarian	reká	rɛˈkɤ		IN_WIKTIONARY
rě̑čь	bulgarian	reč	[ˈrɛtʃ]		CORRECTED
rę̑dъ	bulgarian	red	ˈrɛt	rɛt	DIFFERENT
rìnǫ	bulgarian	rína	ˈrinə
rodjǫ	bulgarian	rodjá	roˈdʲa
rosà	bulgarian	rosá	roˈsa
rovъ	bulgarian	rov	ˈrɔf	rɔf	DIFFERENT
ròjь	bulgarian	roj	rɔj		IN_WIKTIONARY
rȏdъ	bulgarian	rod	rɔt	rɔt	SAME
rȏgъ	bulgarian	rog	rɔk	ˌrɔk	DIFFERENT
rǫbl̹ǫ	bulgarian	rắbja	rabʲa
rǭkà	bulgarian	răká	rɤˈka
rǫ̑bъ	bulgarian	răb	rɤ
rȗdъ	bulgarian	rud	ˈrut	ˌrud̪	DIFFERENT
rỳdlo	bulgarian	rílo	ˈriɫo̝
rỳjǫ	bulgarian	ríja	ˈrijə
rūnò	bulgarian	rúno	ˈruno		IN_WIKTIONARY
sadjǫ	bulgarian	sadjá	səˈdʲa
sedъlò	bulgarian	sedló	sɛdˈlɔ
seló	bulgarian	sélo	ˈsɛlo		IN_WIKTIONARY
serdà	bulgarian	sredá	srɛˈd̪ɤ
sestrà	bulgarian	sestrá	sɛsˈtra		IN_WIKTIONARY
sèdmъ	bulgarian	sédmi	ˈsɛdmi
sèdmь	bulgarian	sédem	ˈsɛdmi		IN_WIKTIONARY
sědjǫ	bulgarian	sedjá	sɛˈdʲɤ		IN_WIKTIONARY
sěkǫ	bulgarian	seká	sɛˈkɤ		IN_WIKTIONARY
sě̀jǫ	bulgarian	séja	ˈsɛjə
sě̀mę	bulgarian	séme	ˈsɛmɛ		IN_WIKTIONARY
sě̀verъ	bulgarian	séver	ˈsɛvɛr		IN_WIKTIONARY
sě̑no	bulgarian	senó	sɛˈnɔ		IN_WIKTIONARY
sęknǫ	bulgarian	sékna	ˈsɛknə
sijàjǫ	bulgarian	sijája	siˈjajə		IN_WIKTIONARY
sìla	bulgarian	síla	ˈsilə		IN_WIKTIONARY
sìto	bulgarian	síto	ˈsit̪o̝
sìvъ	bulgarian	siv	ˈsif	sif	DIFFERENT
slàbъ	bulgarian	slab	slap		IN_WIKTIONARY
slàva	bulgarian	sláva	ˈslavə
slìva	bulgarian	slíva	ˈslivə		IN_WIKTIONARY
slȍvo	bulgarian	slóvo	ˈslɔvo		IN_WIKTIONARY
slȗxъ	bulgarian	slux	slux	slu	DIFFERENT
směxъ	bulgarian	smjax	ˈsmʲax	smʲa	DIFFERENT
smȏrdъ	bulgarian	smrad	[ˈsmrat]		CORRECTED
smějǫ sę	bulgarian	sméja se	ˈsmɛjə sɛ
smьrdjǫ	bulgarian	smărdjá	ˈsmɤrdʲə
sněgъ	bulgarian	snjag	[snjak]		CORRECTED
snovǫ	bulgarian	snová	snoˈvɤ
snъxà	bulgarian	snaxá	snɐˈxa
solnà	bulgarian	slaná	slɐˈna
sovà	bulgarian	sóva	ˈsɔvə
soxà	bulgarian	soxá	soˈxa
sočǫ	bulgarian	sočá	soˈtʃa
sòldъkъ	bulgarian	sládăk	ˈslatək
sòlma	bulgarian	sláma	ˈslamə
sòmъ	bulgarian	som	ˈsɔm		IN_WIKTIONARY
sȏkъ	bulgarian	sok	sɔk		IN_WIKTIONARY
sȏlь	bulgarian	sol	sɔl	sɔɫ	DIFFERENT
sǫ-	bulgarian	să-	sɤ-
sǫdjǫ	bulgarian	sắdja	ˈsɛdja
sǫdì	bulgarian	sădijá	sədiˈja
sǫ́dъ	bulgarian	săd	sɤ
stàdo	bulgarian	stádo	ˈstado
stàrъ	bulgarian	star	star		IN_WIKTIONARY
stànǫ	bulgarian	stána	ˈstanə
stȃnъ	bulgarian	stan	stan		IN_WIKTIONARY
sten̹ǫ	bulgarian	sténa	ˈstɛnə
stìgnǫ	bulgarian	stígna	ˈstiɡnə
stojǫ	bulgarian	stojá	stoˈja
stonъ	bulgarian	ston	stɔn	ˌstɔn	DIFFERENT
stornà	bulgarian	straná	strɐˈna
stòlъ	bulgarian	stol	stɔl	stɔl	SAME
stȏržь	bulgarian	straž	straʃ	straʒ	DIFFERENT
strigǫ	bulgarian	stríža	ˈstriʒə
strǫkъ	bulgarian	străk	ˈstrɤk
strujà	bulgarian	strúja	ˈst̪rujə
studènъ	bulgarian	studén	stuˈdɛn		IN_WIKTIONARY
studъ	bulgarian	stud	[ˈstut]		CORRECTED
stьblò	bulgarian	stăbló	st̪oˈblɔ
stel̹ǫ	bulgarian	stélja	ˈstɛlʲə
sušǫ	bulgarian	sušá	soˈʃa
sȗxъ	bulgarian	sux	ˈsux	sux	DIFFERENT
svekry	bulgarian	svekắrva	ˈsvɛk
svekrъ	bulgarian	svékăr	ˈsvɛkər
svě̄tjà	bulgarian	svešt	[ˈsvɛʃt]		CORRECTED
svě̑tъ	bulgarian	svjat	[ˈsvjat]		CORRECTED
svętъ	bulgarian	svet	ˈsvɛt	svɛt	DIFFERENT
svinьjà	bulgarian	svinjá	sviˈnʲa		IN_WIKTIONARY
svьrbl̹ǫ	bulgarian	sărbí	sɐrˈbi
sỳpl̹ǫ	bulgarian	sípja	ˈsipʲə
sỳtъ	bulgarian	sit	sit̪	sit	DIFFERENT
sỳtъjь	bulgarian	sit	sit̪	sit	DIFFERENT
sy̑nъ	bulgarian	sin	sin		IN_WIKTIONARY
sъ	bulgarian	s	sɤ		IN_WIKTIONARY
sъdòrvъ	bulgarian	zdrav	zdraf		IN_WIKTIONARY
sъlojь	bulgarian	sloj	slɔj	slɔj	SAME
sъmě̀jǫ	bulgarian	sméja	ˈsmɛjə
sъmьrtь	bulgarian	smărt	ˈsmɤrt
sъn	bulgarian	s	sɤ		IN_WIKTIONARY
sъpl̹ǫ	bulgarian	spja	spʲɤ		IN_WIKTIONARY
sъporъ	bulgarian	spor	spɔr	spor	DIFFERENT
sъtȏ	bulgarian	sto	stɔ	stɔ	SAME
sъxnǫ	bulgarian	sắxna	ˈsɛxna
sъ̀nъ	bulgarian	săn	sɤn
sъ̏lnьce	bulgarian	slắnce	ˈslint͡sɛ
sьrna	bulgarian	sărná	sɤrˈna
sь̑rdьce	bulgarian	sărcé	sɤrˈt͡sɛ
tajǫ	bulgarian	tajá	t̪ɐˈjɤ
tàjǫ	bulgarian	tája	ˈt̪ajə		IN_WIKTIONARY
tekǫ	bulgarian	teká	tɛˈkə		IN_WIKTIONARY
těsnъ	bulgarian	tésăn	ˈtɛsən
tě̀mę	bulgarian	téme	ˈt̪ɛmɛ
tě̑sto	bulgarian	testó	tɛsˈtɔ		IN_WIKTIONARY
tęžъkъ	bulgarian	téžăk	ˈtɛʃək
topl̹ǫ	bulgarian	topjá	toˈpʲa
tȏkъ	bulgarian	tok	tɔk		IN_WIKTIONARY
tretь	bulgarian	tréti	ˈt̪rɛt̪i
trě̄và	bulgarian	trevá	trɛˈva		IN_WIKTIONARY
tręsǫ	bulgarian	tresá	trɛˈsɤ		IN_WIKTIONARY
trudъ	bulgarian	trud	ˈtrut	trud	DIFFERENT
trȗpъ	bulgarian	trup	trup	trup	SAME
tryjǫ	bulgarian	tríja	ˈt̪rijə
trāvà	bulgarian	travá	trɐˈva
trъ̑stь	bulgarian	trăst	ˈtrɤst
tučьnъ	bulgarian	túčen	ˈtutʃɛn
tȗrъ	bulgarian	tur	tur	tur	SAME
tvȃrь	bulgarian	tvar	ˈtvar	tvar	DIFFERENT
tvor̹ǫ	bulgarian	tvoríti	tvoˈriti
tvьrdь	bulgarian	tvărd	ˈtfɔrt
tvь̑rdъ	bulgarian	tvărd	ˈtfɔrt
ty	bulgarian	ti	ti		IN_WIKTIONARY
tỳlъ	bulgarian	til	til	til	SAME
tǭgà	bulgarian	tăgá	t̪ɐˈɡa
tьlějǫ	bulgarian	tléja	ˈtlɛjə
tьma	bulgarian	tămá	təˈma
tь̏nьkъ	bulgarian	tắnăk	t͡ʃenək
užasъ	bulgarian	úžas	ˈuʒəs
var̹ǫ	bulgarian	varjá	vəˈrʲa
vedrъ	bulgarian	védăr	ˈvɛdər
vel̹ǫ	bulgarian	vélja	ˈvɛlʲə
velìkъ	bulgarian	velík	vɛˈlik
velkǫ	bulgarian	vleká	vlɛˈkə
vermę	bulgarian	vréme	ˈvrɛmɛ		IN_WIKTIONARY
vertenò	bulgarian	vreténo	vrɛˈt̪ɛno̝
veslò	bulgarian	vesló	vɛsˈlɔ
vetъxъ	bulgarian	vétxi	ˈvɛtsxi
vědrò	bulgarian	vedró	vɛdˈrɔ
větjajǫ	bulgarian	veštája	vɛˈʃt̪ajə
vě̀jǫ	bulgarian	véja	ˈvɛjə
vě̀ra	bulgarian	vjára	ˈvʲarə
vě̀trъ	bulgarian	vjátăr	ˈvʲat̪ər
vȅčerъ	bulgarian	véčer	ˈvɛtʃɛr
vę̄žǫ	bulgarian	véza	ˈvɛzə
virъ	bulgarian	vir	vir	vir	SAME
vьjǫ	bulgarian	víja	ˈvijə
vixъrъ	bulgarian	víxăr	ˈvixər
vìdjǫ	bulgarian	vídja	ˈvidʲə		IN_WIKTIONARY
vȋdъ	bulgarian	vid	vit	vit	SAME
vodà	bulgarian	vodá	voˈd̪a
vodjǫ̀	bulgarian	vódja	ˈvɔdʲə
vojьna	bulgarian	vojná	vɔjˈna		IN_WIKTIONARY
volknò	bulgarian	vlaknó	vləˈknɔ		IN_WIKTIONARY
volstь	bulgarian	vlast	vlast	ˈvlasti	DIFFERENT
vorta	bulgarian	vratá	vrəˈta
voskъ	bulgarian	vósăk	ˈvɔsək
vožǫ̀	bulgarian	vózja	ˈvɔzʲə
vòlga	bulgarian	vlága	ˈvɫaɡə		IN_WIKTIONARY
vòl̨a	bulgarian	vólja	ˈvɔlʲə		IN_WIKTIONARY
vòrna	bulgarian	vrána	ˈvranə		IN_WIKTIONARY
vȏlkъ	bulgarian	vlak	vlak		IN_WIKTIONARY
vȏrgъ	bulgarian	vrag	vrak		IN_WIKTIONARY
vȏrnъ	bulgarian	vran	ˈvran	vran	DIFFERENT
vysòkъ	bulgarian	visók	viˈsɔk		IN_WIKTIONARY
vỳmę	bulgarian	víme	ˈvimɛ
v̀ydra	bulgarian	vídra	ˈvidrə		IN_WIKTIONARY
vъ	bulgarian	v	vɤf		IN_WIKTIONARY
vъn	bulgarian	v	vɤf		IN_WIKTIONARY
vъnùkъ	bulgarian	vnuk	ˈvnuk	vnɔk	DIFFERENT
vъnъ	bulgarian	văn	ˈvɤn
vьdovà	bulgarian	vdovíca	vdɔˈvitsə
vьlgъkъ	bulgarian	vóhkyj	ˈvɔxkʲij
vьlnà	bulgarian	vălná	vɤlˈna
vьrǫ	bulgarian	vrja	[ˈvrja]		CORRECTED
vьrtjǫ	bulgarian	vărtjá	vɤrˈtʲa
vьčera	bulgarian	včéra	ˈftʃɛrə
vь̀lna	bulgarian	vắlna	ˈvɛɫnə
vь̀rxъ	bulgarian	vrăx	ˈvrɤx
vь̑lkъ	bulgarian	vălk	ˈvɤɫk
xabl̹ǫ	bulgarian	xabjá	xɐˈbʲa
xabьnъ	bulgarian	xáben	ˈxabn
xlě̀bъ	bulgarian	xljab	xlʲa̟b	xlʲab	DIFFERENT
xodjǫ	bulgarian	xódja	ˈxɔdʲə
xoldьnъ	bulgarian	hláden	ˈhlɑdɛn		IN_WIKTIONARY
xomǫtъ	bulgarian	xomót	xoˈmɔt
xorbrъ	bulgarian	xrábăr	ˈxrabər
xorna	bulgarian	xraná	xrɐˈna
xorn̹ǫ	bulgarian	xránja	ˈxranʲə
xȏdъ	bulgarian	xod	xɔt	xɔd	DIFFERENT
xȏldъ	bulgarian	xlad	xlat	xlat	SAME
xromъ	bulgarian	xrom	xrɔm	xrɔm	SAME
xvórstъ	bulgarian	xrast	xrast	xrast	SAME
zabordlo	bulgarian	zabrálo	zɐˈbraɫo̝
zelènъ	bulgarian	zelén	zɛˈlɛn
zeml̨à	bulgarian	zemjá	zɛˈmʲa
zěnica	bulgarian	zeníca	zɛˈnitsə
zę̀tь	bulgarian	zet	zɛt		IN_WIKTIONARY
zìnǫ	bulgarian	zína	ˈzinə
zmьjà	bulgarian	zmijá	zmiˈja		IN_WIKTIONARY
zmь̀jь	bulgarian	zmej	zmɛi		IN_WIKTIONARY
znàmę	bulgarian	známe	ˈznamɛ		IN_WIKTIONARY
znojь	bulgarian	znoj	znɔj	znɔj	SAME
zȍlto	bulgarian	zláto	ˈzlato		IN_WIKTIONARY
zȏrkъ	bulgarian	zrak	zrak	zrak	SAME
zīmà	bulgarian	zíma	ˈzimə		IN_WIKTIONARY
zъly	bulgarian	zắlva	zɛɫvɤ
zъlъ	bulgarian	zăl	zɤl
zьlčь	bulgarian	zlăč	zlɤtʃ
zьr̹ǫ	bulgarian	zra	zrɤ		IN_WIKTIONARY
zь̀rno	bulgarian	zắrno	zˈrɛno
čarodějь	bulgarian	čarodéj	tʃəɾoˈd̪ɛj
čarъ	bulgarian	čar	tʃar	ˈtʃar	DIFFERENT
čàsъ	bulgarian	čas	tʃas		IN_WIKTIONARY
čelověkъ	bulgarian	čelovék	tʃɛloˈvɛk
čelò	bulgarian	čeló	tʃɛˈlɔ
četvьrtъ	bulgarian	četvắrti	tʃetˈvrrti
četỳre	bulgarian	četíri	tʃɛˈt̪iɾi
čèznǫ	bulgarian	čézna	ˈtʃɛznə
čȇrpъ	bulgarian	čérep	ˈtʃɛrɛp
čȇrvo	bulgarian	červó	tʃerˈvɔ
čęstъ	bulgarian	čésto	ˈtʃɛst̪o
čę̑stь	bulgarian	čast	tʃast	ˈtʃast̪	DIFFERENT
čin̹ǫ	bulgarian	čínja	ˈtʃinʲə
čìstjǫ	bulgarian	čístja	ˈtʃistʲə
čìstъ	bulgarian	čist	[ˈt͡ʃist]		CORRECTED
čȋnъ	bulgarian	čin	[ˈtʃin]		CORRECTED
čudjǫ	bulgarian	čúdja	ˈtʃudʲə
čùdo	bulgarian	čúdo	ˈtʃudo		IN_WIKTIONARY
čùjǫ	bulgarian	čúja	ˈtʃujə		IN_WIKTIONARY
črěpl̹ǫ	bulgarian	čérpja	ˈtʃɛrpʲə
čьrtà	bulgarian	čertá	tʃɛrˈt̪a
čьto	bulgarian	što	ʃtɔ		IN_WIKTIONARY
čь̀rnъ	bulgarian	čéren	ˈtʃɛrɛn
čь̑stь	bulgarian	čest	tʃɛst̪		IN_WIKTIONARY
ę̄drò	bulgarian	jedró	jɛdˈrɔ
ę̄trò	bulgarian	jatró	jəˈtrɔ
šȇstъ	bulgarian	šésti	ˈʃɛst̪i
šȇstь	bulgarian	šest	ˈʃɛsti		IN_WIKTIONARY
šьjǫ	bulgarian	šíja	ˈʃijə		IN_WIKTIONARY
šurь	bulgarian	šúrej	ˈʃuɾɛj
ščítъ	bulgarian	štit	ʃtit	ˈʃtit̪	DIFFERENT
ūstà	bulgarian	ustá	usˈta		IN_WIKTIONARY
žalь	bulgarian	žal	ʒaɫ	ʒaɫ	SAME
žarъ	bulgarian	žar	ʒar	ʒar	SAME
žàba	bulgarian	krastava ž.	ˈkrastavə ʒe
želě̀zo	bulgarian	željázo	ʒɛˈlʲazo
želza	bulgarian	žlezá	ʒlɛˈza
ženà	bulgarian	žená	ʒɛˈna		IN_WIKTIONARY
žeravь	bulgarian	žérav	ˈʒɛrəf
žerbьjь	bulgarian	žrébie	ʒrˈɛbiɛ
žerdlò	bulgarian	žreló	ʒrɛˈɫɔ
žȅlǫdь	bulgarian	žélăd	ˈʒɛɫət̪
žędьnъ	bulgarian	žáden	ˈʒadɛn		IN_WIKTIONARY
žьnǫ	bulgarian	žắna	ʒɛn
žę̀tva	bulgarian	žắtva	ʒɛt̪ˈvɤ
živòtъ	bulgarian	živót	ʒiˈvɔt
žìca	bulgarian	žíca	ˈʒitsə
žìla	bulgarian	žíla	ˈʒiɫə
žìto	bulgarian	žíto	ˈʒit̪o̝
žȋvъ	bulgarian	živ	ʒif	ʒif	SAME
žùna	bulgarian	žúna	ˈʒunə
žьltъ	bulgarian	žălt	ʒɤɫt
žьrьcь	bulgarian	žrec	ʒrɛt͡s	ʒrɛt͡s	SAME
arьmò	bulgarian	jarém	jəˈrɛm
àblo	bulgarian	jáblo	ˈjabɫo
àblъka	bulgarian	jábălka	ˈjapəlkə
àstrě̄bъ	bulgarian	jástreb	ˈjastrɛp
ȁsenъ	bulgarian	jásen	ˈjasɛn
bȁsn̨a	bulgarian	básnja	ˈbasnʲə
bobrъ	bulgarian	bóbăr	ˈbɔbər
bedrò	bulgarian	bedró	bɛdˈrɔ
bolnъ	bulgarian	bljan	ˈbljan	ˈblʲan	DIFFERENT
blizna	bulgarian	blizná	blizˈna
blizъkъ	bulgarian	blízăk	ˈblisək
blizь	bulgarian	blízo	ˈblizo
bràtъ	bulgarian	brat	brat		IN_WIKTIONARY
brъsnǫ	bulgarian	brắsna	ˈbrɛsnə
bъ̀drъ	bulgarian	bódăr	ˈbɔdər
divъ	bulgarian	div	dif	div	DIFFERENT
dupę	bulgarian	dúpe	ˈdupɛ
ebǫ	bulgarian	jebá	jɛˈbə
edinakъ	bulgarian	edín	ˈpɤrvi		IN_WIKTIONARY
edìnъ	bulgarian	edín	ˈpɤrvi		IN_WIKTIONARY
edlà	bulgarian	jelá	jɛˈɫa
edvà	bulgarian	edvá	ɛdˈva
olbodà	bulgarian	lóboda	ˈlɔbodə
elbedь	bulgarian	lébed	ˈlɛbɛt		IN_WIKTIONARY
elenъ	bulgarian	jelén	jɛˈlɛn
elьxa	bulgarian	elxá	ɛlˈxa
emešь	bulgarian	émeš	ˈɛmɛʃ
esètra	bulgarian	esétra	ɛˈsɛt̪rə
ězъ	bulgarian	jaz	jas	ja	DIFFERENT
ȅzerъ	bulgarian	ézero	ˈɛzɛro		IN_WIKTIONARY
ęga	bulgarian	enzá	ɛnˈza
gleznъ	bulgarian	glézen	ˈɡlɛzɛn
glěnь	bulgarian	glen	ɡlɛn	ɡlɛn	SAME
glístъ	bulgarian	glist	ˈɡlist	ɡlist	DIFFERENT
gluma	bulgarian	glúma	ˈɡlumə
gǫgnǫ	bulgarian	gắgna	ˈɡɛɡna
gǫgnavъ	bulgarian	găgnív	ɡɐɡˈnif
gǫžьva	bulgarian	gắžva	ˈɡɛʒvə
grubъ	bulgarian	grub	ˈɡrup	ɡrub	DIFFERENT
gruda	bulgarian	grúda	ˈɡrudə
gъrbъ	bulgarian	grăb	ˈɡrɤp
gъrno	bulgarian	gărné	ˈɡrɛnɛ
jesìka	bulgarian	jèsika	ˈjesikə
jьgra	bulgarian	igrá	iˈɡra		IN_WIKTIONARY
kogъda	bulgarian	kogá	koˈɡa
koterъ	bulgarian	kótryj	ˈkɔtrij
košarъ	bulgarian	košára	koˈʃaɾə
kyselъ	bulgarian	kísel	ˈkisɛɫ
kъlka	bulgarian	kắlka	ˈkalkɐ
lemešь	bulgarian	leméž	lɛˈmɛʃ
màjǫ	bulgarian	mája	ˈmajə
man̹ǫ	bulgarian	mámja	ˈmamʲə
matorьnъ	bulgarian	matórnyj	mɐˈt̪ɔɾnij
mèčь	bulgarian	meč	mɛt͡ʃ		IN_WIKTIONARY
mě̑xъ	bulgarian	mjax	ˈmʲax	ˈmʲax	SAME
mьglà	bulgarian	măglá	məˈɡla
muzga	bulgarian	múzga	ˈmuzɡə
mьstь	bulgarian	mьstь	ˈmɛst̪
norvъ	bulgarian	nrav	nraf	nraf	SAME
nozdra	bulgarian	nózdra	ˈnɔzdrə
nùdja	bulgarian	núžda	ˈnuʒd̪ə
oborъ	bulgarian	obór	oˈbɔr
òrmę	bulgarian	rámo	ˈramo		IN_WIKTIONARY
ȍlkъtь	bulgarian	lákăt	ˈlakət
ȍpakъ	bulgarian	ópak	ˈɔpək
po	bulgarian	po	po		IN_WIKTIONARY
pelenà	bulgarian	pelená	pɛlɛˈna		IN_WIKTIONARY
pěga	bulgarian	péga	ˈpɛɡə
pȅpelъ	bulgarian	pépel	ˈpɛpɛl		IN_WIKTIONARY
piskalъ	bulgarian	piskál	piˈskaɫ
pǫpъ	bulgarian	păp	pɤp
pro	bulgarian	pro-	ˈprɔ̟ɫ	prɔ	DIFFERENT
protivo	bulgarian	protív	proˈt̪if
pьkъlъ	bulgarian	pắkăl	pŋkɤɫ
sol(o)vikъ	bulgarian	slávej	ˈslavɛj		IN_WIKTIONARY
svòrka	bulgarian	svráka	ˈsvrakə		IN_WIKTIONARY
surovъ	bulgarian	suróv	suˈrɔf
tesla	bulgarian	teslá	tɛˈsla
tęga	bulgarian	tjága	ˈtʲaɡə
tri	bulgarian	tri	[ˈtri]		CORRECTED
voinъ	bulgarian	vojník	vojˈnik
vòn̨a	bulgarian	vonjá	voˈnʲa
vъtorьnikъ	bulgarian	vtórnik	ˈftɔrnik		IN_WIKTIONARY
zidъ	bulgarian	zid	zit̪	zit	DIFFERENT
zějǫ	bulgarian	zéja	ˈzɛjə
zȏbь	bulgarian	zob	zɔp	zob	DIFFERENT
čemerika	bulgarian	čemeríka	tʃemeˈrikə
čerdà	bulgarian	čerdá	tʃerˈda
čersъ	bulgarian	črez	ˈtʃrɛs	tʃrɛs	DIFFERENT
česnъ	bulgarian	čésăn	ˈtʃɛsən
čędъ	bulgarian	čédo	ˈtʃɛd̪o
želàjǫ	bulgarian	želája	ʒɛˈɫajə		IN_WIKTIONARY
žezlъ	bulgarian	žézăl	ˈʒɛzəɫ
