a	old_church_slavic	a	a
ajьce	old_church_slavic	aice	ait͡sɛ
ako	old_church_slavic	jako	jakɔ
akъ	old_church_slavic	jakъ	jakʊ
akъjь	old_church_slavic	jakъ	jakʊ
avě	old_church_slavic	javě	javæ
aviti	old_church_slavic	javiti	javiti
azъ	old_church_slavic	azъ	azʊ
aščerъ	old_church_slavic	aštera	aʃtɛra
àgnę	old_church_slavic	agnę	agnɛ̃
àgnьcь	old_church_slavic	agnьcь	agnɪt͡sɪ
àma	old_church_slavic	jama	jama
ȁgoda	old_church_slavic	agoda	agɔda
badli	old_church_slavic	balii	balii
ubadlovati	old_church_slavic	ubalovati	ubalɔvati
bȁba	old_church_slavic	baba	baba
bergtì	old_church_slavic	nebrěšti	nɛbræʃti
bez	old_church_slavic	bez	bɛz
bezъ	old_church_slavic	bez	bɛz
bèrmę	old_church_slavic	brěmę	bræmɛ̃
běžàti	old_church_slavic	běžati	bæʒati
bě̀gati	old_church_slavic	běgati	bægati
bě́lъ	old_church_slavic	bělъ	bælʊ
bě̄dà	old_church_slavic	běda	bæda
bě̄dìti	old_church_slavic	běditi	bæditi
bě̑sъ	old_church_slavic	běsъ	bæsʊ
bȇrgъ	old_church_slavic	brěgъ	brægʊ
bìti	old_church_slavic	biti	biti
bìčь	old_church_slavic	bičь	bit͡ʃɪ
blě̑dъ	old_church_slavic	blědъ ʹpaleʹ 	blædʊ ʹpalɛʹ 
blędь	old_church_slavic	blędь	blɛ̃dɪ
blęsti	old_church_slavic	blęsti	blɛ̃sti
bliskъ	old_church_slavic	bliskъ	bliskʊ
blǭdìti	old_church_slavic	blǫditi	blɔ̃diti
blǫ̑dъ	old_church_slavic	blǫdъ	blɔ̃dʊ
bl̨ustì	old_church_slavic	bljusti	bʎusti
bl̨ьvàti	old_church_slavic	blʹьvati	bʎɪvati
blьščati sę	old_church_slavic	blьštati sę	blɪʃtati sɛ̃
bo	old_church_slavic	bo	bɔ
bogàtъ	old_church_slavic	bogatъ	bɔgatʊ
bojati sę	old_church_slavic	bojati sę	bɔjati sɛ̃
bojaznь	old_church_slavic	bojaznь	bɔjaznɪ
ubojь	old_church_slavic	uboi	ubɔi
bolěti	old_church_slavic	bolěti	bɔlæti
bol̨e	old_church_slavic	bolje	bɔʎɛ
bol̨eje	old_church_slavic	bolje	bɔʎɛ
bolьjьjь	old_church_slavic	bol̨ii	bɔl̨ii
bordà	old_church_slavic	brada	brada
borzdà	old_church_slavic	brazda	brazda
bostì	old_church_slavic	bosti	bɔsti
bòlto	old_church_slavic	blato	blatɔ
bòrti sę	old_church_slavic	brati sę	brati sɛ̃
bȍršьno	old_church_slavic	brašьno	braʃɪnɔ
bȏgъ	old_church_slavic	bogъ	bɔgʊ
bȏlgo	old_church_slavic	blago	blagɔ
bȏlgъ	old_church_slavic	blagъ	blagʊ
bȏlь	old_church_slavic	bolь	bɔlɪ
bȏrnь	old_church_slavic	branь	branɪ
probrězgъ	old_church_slavic	probrězgъ	prɔbræzgʊ
bridъkъ	old_church_slavic	bridъkъ	bridʊkʊ
brìtva	old_church_slavic	britva	britva
bry	old_church_slavic	brьvьmi	brɪvɪmi
brysadlo	old_church_slavic	brysalo	brɨsalɔ
brъzda	old_church_slavic	brъzdami	brʊzdami
brьna	old_church_slavic	brъnojǫ	brʊnɔjɔ̃
brьnьje	old_church_slavic	brьnije	brɪnijɛ
brьvъnò	old_church_slavic	brьvьno	brɪvɪnɔ
bujьjь	old_church_slavic	bui	bui
bùr̨a	old_church_slavic	burja	burʲa
bylьje	old_church_slavic	bylije	bɨlijɛ
bytьje	old_church_slavic	bytije	bɨtijɛ
byvati	old_church_slavic	byvati	bɨvati
bỳstrъ	old_church_slavic	bystrъ	bɨstrʊ
bỳti	old_church_slavic	byti	bɨti
ubūdìti	old_church_slavic	ubuditi	ubuditi
bъděti	old_church_slavic	bъděti	bʊdæti
bъ̑rz	old_church_slavic	br̩zo	br̩zɔ
bьrati	old_church_slavic	bьrati	bɪrati
bьčelà	old_church_slavic	bьčela	bɪt͡ʃɛla
cè̌sta	old_church_slavic	cěsta	t͡sæsta
cě	old_church_slavic	cě	t͡sæ
cělovàti	old_church_slavic	cělovati	t͡sælɔvati
cěstiti	old_church_slavic	cěstiti	t͡sæstiti
cěvьnica	old_church_slavic	cěvьnica	t͡sævɪnit͡sa
cě̄lìti	old_church_slavic	cěliti	t͡sæliti
cě̄nà	old_church_slavic	cěna	t͡sæna
cě̄nìti	old_church_slavic	cěniti	t͡sæniti
cě̑lъ	old_church_slavic	cělъ	t͡sælʊ
da	old_church_slavic	da	da
dadja	old_church_slavic	dažda	daʒda
dajati	old_church_slavic	dajati	dajati
dalèkъ	old_church_slavic	daleče	dalɛt͡ʃɛ
datelь	old_church_slavic	datel̨ь	datɛl̨ɪ
dàti	old_church_slavic	dati	dati
dȃnь	old_church_slavic	danь	danɪ
dȃrъ	old_church_slavic	darъ	darʊ
debelьstvo	old_church_slavic	debelьstvo	dɛbɛlɪstvɔ
desętъ	old_church_slavic	desętъ	dɛsɛ̃tʊ
desiti	old_church_slavic	desiti	dɛsiti
devętъ	old_church_slavic	devętъ	dɛvɛ̃tʊ
dělati	old_church_slavic	dělati	dælati
děliti	old_church_slavic	dělitъ	dælitʊ
děti	old_church_slavic	děti	dæti
děvìca	old_church_slavic	děvica	dævit͡sa
dě̀dъ	old_church_slavic	dědъ	dædʊ
dě̀lo	old_church_slavic	dělo	dælɔ
dě̀va	old_church_slavic	děva	dæva
dȅsętь	old_church_slavic	desętь	dɛsɛ̃tɪ
dȅsnъ	old_church_slavic	desnъ	dɛsnʊ
dȅvętь	old_church_slavic	devętь	dɛvɛ̃tɪ
dȇrvo	old_church_slavic	drěvo	drævɔ
divъ	old_church_slavic	divъ	divʊ
divьnъ	old_church_slavic	divьnъ	divɪnʊ
dȋvo	old_church_slavic	divesa	divɛsa
do	old_church_slavic	do	dɔ
dobl̨ь	old_church_slavic	doblʹь	dɔbʎɪ
dobrъ	old_church_slavic	dobrъ	dɔbrʊ
dojidlica	old_church_slavic	doilicь	dɔilit͡sɪ
dojìti	old_church_slavic	doiti	dɔiti
dolъ	old_church_slavic	dolu	dɔlu
dovьlěti	old_church_slavic	dovьlěti	dɔvɪlæti
dòlnь	old_church_slavic	dlanь	dlanɪ
dȍma	old_church_slavic	doma	dɔma
dȏmъ	old_church_slavic	domъ	dɔmʊ
dȏrgъ	old_church_slavic	dragъ	dragʊ
dǫ̀ti	old_church_slavic	dъmy	dʊmɨ
dǫ̑bъ	old_church_slavic	dǫbъ	dɔ̃bʊ
drobìti	old_church_slavic	droběi	drɔbæi
drobьnъ	old_church_slavic	drobenъ	drɔbɛnʊ
drǫ́gъ	old_church_slavic	drǫgy	drɔ̃gɨ
družìna	old_church_slavic	družina	druʒina
drȗgъ	old_church_slavic	drugъ	drugʊ
drāžìti	old_church_slavic	razdražiti	razdraʒiti
drъ̏vo	old_church_slavic	drъva	drʊva
dunǫti	old_church_slavic	dunǫti	dunɔ̃ti
dupina	old_church_slavic	dupinǫ	dupinɔ̃
dȗxъ	old_church_slavic	duxъ	duxʊ
dva	old_church_slavic	dъva	dʊva
dvojь	old_church_slavic	dъvoi	dʊvɔi
dvòrъ	old_church_slavic	dvorъ	dvɔrʊ
dvьrь	old_church_slavic	dvьrь	dvɪrɪ
dỳmъ	old_church_slavic	dymъ	dɨmʊ
dzělo	old_church_slavic	dzělo	dzælɔ
dāvàti	old_church_slavic	-davati	-davati
dāvìti	old_church_slavic	daviti	daviti
dīvìti sę	old_church_slavic	diviti sę	diviti sɛ̃
dūxàti	old_church_slavic	duxati	duxati
dūšà	old_church_slavic	duša	duʃa
dъkti	old_church_slavic	dъšti	dʊʃti
dъnò	old_church_slavic	dъno	dʊnɔ
dъva	old_church_slavic	dъva	dʊva
dъvojь	old_church_slavic	dъvoi	dʊvɔi
dъxnǫti	old_church_slavic	dъxnǫti	dʊxnɔ̃ti
dъxъ	old_church_slavic	dъxъ	dʊxʊ
dъždžь	old_church_slavic	dъždь	dʊʒdɪ
dъ̑lgъ	old_church_slavic	dъlgъ	dʊlgʊ
dьbrь	old_church_slavic	dьbrь	dɪbrɪ
dьlgotà	old_church_slavic	dl̩gota	dl̩gɔta
prodьliti	old_church_slavic	prodьljǫ	prɔdɪʎɔ̃
dьnьsь	old_church_slavic	dьnьsь	dɪnɪsɪ
dьrati	old_church_slavic	dьrati	dɪrati
dьrzati	old_church_slavic	dr̩zati	dr̩zati
dьrznǫti	old_church_slavic	dr̩znǫti	dr̩znɔ̃ti
dьrzъ	old_church_slavic	dr̩zъ	dr̩zʊ
dьržati sę	old_church_slavic	 drьžati	 drɪʒati
dь̀lgъ	old_church_slavic	dl̩gъ	dl̩gʊ
dь̑nь	old_church_slavic	dьnь	dɪnɪ
ertь	old_church_slavic	retь	rɛtɪ
ese	old_church_slavic	ese	ɛsɛ
esmь	old_church_slavic	jesmь	jɛsmɪ
estь	old_church_slavic	jestъ	jɛstʊ
eterъ	old_church_slavic	eterъ	ɛtɛrʊ
ešče	old_church_slavic	ješte	jɛʃtɛ
ědro	old_church_slavic	jadra	jadra
ěrostь	old_church_slavic	jarostь	jarɔstɪ
ěsti	old_church_slavic	jasti	jasti
ěxati	old_church_slavic	jaxati	jaxati
ě̀snъ	old_church_slavic	jasnъ	jasnʊ
ě̀zva	old_church_slavic	jazva	jazva
ě̑dь	old_church_slavic	jadь	jadɪ
ě̑rъ	old_church_slavic	jarъ	jarʊ
ȇ̌dъ	old_church_slavic	jadъ	jadʊ
edrъjь	old_church_slavic	ędri	ɛ̃dri
ęti	old_church_slavic	jęti	jɛ̃ti
ęzỳkъ	old_church_slavic	językъ	jɛ̃zɨkʊ
gàdъ	old_church_slavic	gadъ	gadʊ
glàdъkъ	old_church_slavic	gladъkъ	gladʊkʊ
glę̀dati	old_church_slavic	ględati	glɛ̃dati
glǫbòkъ	old_church_slavic	glǫbokъ	glɔ̃bɔkʊ
glumiti sę	old_church_slavic	glumiti sę	glumiti sɛ̃
glȗxъ	old_church_slavic	gluxъ	gluxʊ
gnestì	old_church_slavic	gnesti	gnɛsti
gně̀vъ	old_church_slavic	gněvъ	gnævʊ
gně̄zdò	old_church_slavic	gnězdo	gnæzdɔ
gnȏjь	old_church_slavic	gnoi	gnɔi
gnǫsьnъ	old_church_slavic	gnǫsьnъ	gnɔ̃sɪnʊ
gnǫšati sę	old_church_slavic	gnǫšati sę	gnɔ̃ʃati sɛ̃
gnusьnъ	old_church_slavic	gnusьnъ	gnusɪnʊ
gnušati sę	old_church_slavic	gnušati sę	gnuʃati sɛ̃
gńìti	old_church_slavic	gnijǫštii	gnijɔ̃ʃtii
gnьsь	old_church_slavic	gnesь	gnɛsɪ
gobino	old_church_slavic	gobině	gɔbinæ
godina	old_church_slavic	godina	gɔdina
goditi	old_church_slavic	godę	gɔdɛ̃
godъ	old_church_slavic	godъ	gɔdʊ
golěnь	old_church_slavic	golěnь	gɔlænɪ
golgolati	old_church_slavic	glagolati	glagɔlati
golgolъ	old_church_slavic	glagolъ	glagɔlʊ
golvà	old_church_slavic	glava	glava
goněti	old_church_slavic	goněti	gɔnæti
gonìti	old_church_slavic	goniti	gɔniti
gorà	old_church_slavic	gora	gɔra
gorěti	old_church_slavic	gorěti	gɔræti
gorьjьjь	old_church_slavic	gor̨ii	gɔr̨ii
gorьkъ	old_church_slavic	gorьkъ	gɔrɪkʊ
gospodinъ	old_church_slavic	gospodinъ	gɔspɔdinʊ
gospodь	old_church_slavic	gospodь	gɔspɔdɪ
gověti	old_church_slavic	gověti	gɔvæti
govorìti	old_church_slavic	govoriti	gɔvɔriti
govorъ	old_church_slavic	govorъ	gɔvɔrʊ
gòlъ	old_church_slavic	golъ	gɔlʊ
gȍlǫbь	old_church_slavic	golǫbь	gɔlɔ̃bɪ
gȍr̨e	old_church_slavic	gorje	gɔrʲɛ
gȏldъ	old_church_slavic	gladъ	gladʊ
gȏlsъ	old_church_slavic	glasъ	glasʊ
gȏrdъ	old_church_slavic	gradъ	gradʊ
gȏstь	old_church_slavic	gostemъ	gɔstɛmʊ
gǫgnivъ	old_church_slavic	gǫgъnivъ	gɔ̃gʊnivʊ
gǫ̀ba	old_church_slavic	gǫba	gɔ̃ba
gramada	old_church_slavic	gramada	gramada
gràbiti	old_church_slavic	grabiti	grabiti
gràdъ	old_church_slavic	gradъ	gradʊ
greti	old_church_slavic	greti	grɛti
grějati	old_church_slavic	grějati	græjati
grěti	old_church_slavic	grějati	græjati
grě́xъ	old_church_slavic	grěxъ	græxʊ
gręsti	old_church_slavic	gręsti	grɛ̃sti
pogrę̑znǫti	old_church_slavic	pogręznǫti	pɔgrɛ̃znɔ̃ti
grobъ	old_church_slavic	grobъ	grɔbʊ
grozà	old_church_slavic	groza	grɔza
grozьnъ	old_church_slavic	grozъnъ	grɔzʊnʊ
gròzdъ	old_church_slavic	grozdъ	grɔzdʊ
grȏmъ	old_church_slavic	gromъ	grɔmʊ
pogrǫziti	old_church_slavic	pogrǫziti	pɔgrɔ̃ziti
grỳzti	old_church_slavic	grizetъ	grizɛtʊ
grъmъ	old_church_slavic	σαβέκ	σαβέκ
grьměti	old_church_slavic	grъmę	grʊmɛ̃
gubìti	old_church_slavic	gubiti	gubiti
gumьnò	old_church_slavic	gumьno	gumɪnɔ
gvě̄zdà	old_church_slavic	dzvězda	dzvæzda
gvozdi	old_church_slavic	gvozdii	gvɔzdii
gybati	old_church_slavic	gybati	gɨbati
gỳnǫti	old_church_slavic	gybnǫti	gɨbnɔ̃ti
ugāsìti	old_church_slavic	ugasiti	ugasiti
gъnàti	old_church_slavic	gъnati	gʊnati
gъrnidlo	old_church_slavic	gr̩nilъ	gr̩nilʊ
gъ̑rdъ	old_church_slavic	gr̩dъ	gr̩dʊ
gъ̑rstь	old_church_slavic	gr̩stijо̨	gr̩stijо̨
i	old_church_slavic	i	i
ju	old_church_slavic	uže	uʒɛ
juže	old_church_slavic	uže	uʒɛ
jùgъ	old_church_slavic	jugъ	jugʊ
jȗnъ	old_church_slavic	junъ	junʊ
jьde	old_church_slavic	ide	idɛ
jьgrati	old_church_slavic	igrati	igrati
jьmàti	old_church_slavic	imati	imati
jьměti	old_church_slavic	iměti	imæti
jьmę	old_church_slavic	imę	imɛ̃
jь̑go	old_church_slavic	igo	igɔ
kadìdlo	old_church_slavic	kadilo	kadilɔ
kakъ	old_church_slavic	kakъ	kakʊ
kamy	old_church_slavic	kamy	kamɨ
kasati sę	old_church_slavic	kasati sę	kasati sɛ̃
kazati	old_church_slavic	kazati	kazati
kaziti	old_church_slavic	kaziti	kaziti
kaznь	old_church_slavic	kaznь	kaznɪ
kàjati sę	old_church_slavic	kajati sę	kajati sɛ̃
kȃlъ	old_church_slavic	kalъ	kalʊ
klasti	old_church_slavic	klasti	klasti
klětь	old_church_slavic	klětь	klætɪ
klęčati	old_church_slavic	klęčęšta	klɛ̃t͡ʃɛ̃ʃta
klokotati	old_church_slavic	klokotati	klɔkɔtati
kl̨učiti sę	old_church_slavic	ključiti sę	kʎut͡ʃiti sɛ̃
kl̨účь	old_church_slavic	ključь	kʎut͡ʃɪ
kobь	old_church_slavic	kobь	kɔbɪ
kokotъ	old_church_slavic	kokotъ	kɔkɔtʊ
kokošь	old_church_slavic	kokošь	kɔkɔʃɪ
kolě̀no	old_church_slavic	kolěno	kɔlænɔ
koliko	old_church_slavic	koliko	kɔlikɔ
kolo	old_church_slavic		
kolti	old_church_slavic	klati	klati
koltiti	old_church_slavic	klatiti	klatiti
konьcь	old_church_slavic	konьcь	kɔnɪt͡sɪ
kopati	old_church_slavic	kopati	kɔpati
koprъ	old_church_slavic	koprъ	kɔprʊ
kopьje	old_church_slavic	kopije	kɔpijɛ
korbī	old_church_slavic	krabii	krabii
korda	old_church_slavic	krada	krada
korenь	old_church_slavic	korenь	kɔrɛnɪ
korica	old_church_slavic	koricę	kɔrit͡sɛ̃
korìti	old_church_slavic	koriti	kɔriti
korьcь	old_church_slavic	korecъ	kɔrɛt͡sʊ
kosnǫti sę	old_church_slavic	kosnǫti sę	kɔsnɔ̃ti sɛ̃
kovati	old_church_slavic	kovati	kɔvati
kozà	old_church_slavic	koza	kɔza
kozьlъ	old_church_slavic	kozьlъ	kɔzɪlʊ
kòlda	old_church_slavic	gladǫ	gladɔ̃
kòlъ	old_church_slavic	kolъ	kɔlʊ
kòn̨ь	old_church_slavic	kon̨ь	kɔn̨ɪ
kòrsta	old_church_slavic	krasta	krasta
kòšь	old_church_slavic	košь	kɔʃɪ
kòža	old_church_slavic	koža	kɔʒa
kórtъ	old_church_slavic	kratъ	kratʊ
kȏlsъ	old_church_slavic	klasъ	klasʊ
kȏstь	old_church_slavic	kostь	kɔstɪ
kǫpina	old_church_slavic	kǫpina	kɔ̃pina
kǫsati	old_church_slavic	kǫsati	kɔ̃sati
kǫtja	old_church_slavic	kǫštę	kɔ̃ʃtɛ̃
kǫ́tъ	old_church_slavic	kǫtъ	kɔ̃tʊ
krasà	old_church_slavic	krasojǫ	krasɔjɔ̃
krasti	old_church_slavic	krasti	krasti
krasьnъ	old_church_slavic	krasьnъ	krasɪnʊ
krěpъ	old_church_slavic	krěpъ	kræpʊ
krěpъkъ	old_church_slavic	krěpъkъ	kræpʊkʊ
krinica	old_church_slavic	krinicǫ	krinit͡sɔ̃
kričati	old_church_slavic	kričati	krit͡ʃati
kromě	old_church_slavic	kromě	krɔmæ
kropiti	old_church_slavic	kropiti	krɔpiti
krotiti	old_church_slavic	krotiti	krɔtiti
krotъkъ	old_church_slavic	krotъkъ	krɔtʊkʊ
krovъ	old_church_slavic	krovъ	krɔvʊ
krǫ̑gъ	old_church_slavic	krǫgъ	krɔ̃gʊ
kry	old_church_slavic	kry	krɨ
krỳti	old_church_slavic	kryti	krɨti
krīdlò	old_church_slavic	krilo	krilɔ
krъvьnъ	old_church_slavic	krъvьnъ	krʊvɪnʊ
kujati	old_church_slavic	kujajǫšta	kujajɔ̃ʃta
kurenьje	old_church_slavic	kurenije	kurɛnijɛ
kurъ	old_church_slavic	kurъ	kurʊ
kùditi	old_church_slavic	kudętъ	kudɛ̃tʊ
kùpъ	old_church_slavic	kupъ	kupʊ
kvȃsъ	old_church_slavic	kvasъ	kvasʊ
kvě̑tъ	old_church_slavic	cvětъ	t͡svætʊ
kvisti	old_church_slavic	cvisti	t͡svisti
kypě̀ti	old_church_slavic	kypěti	kɨpæti
kyvati	old_church_slavic	kyvati	kɨvati
kādìti	old_church_slavic	kaditi	kaditi
kūrìti sę	old_church_slavic	kuritъ sę	kuritʊ sɛ̃
kъ	old_church_slavic	kъ	kʊ
kъde	old_church_slavic	kъde	kʊdɛ
kъjь	old_church_slavic	kъi	kʊi
kъk(ъ)n̨ь	old_church_slavic	kъkъnju	kʊkʊɲu
kъn	old_church_slavic	kъ	kʊ
kъrknǫti	old_church_slavic	krъknǫti	krʊknɔ̃ti
kъto	old_church_slavic	kъto	kʊtɔ
kъznь	old_church_slavic	kъznь	kʊznɪ
kъ̀rpa	old_church_slavic	krъpa	krʊpa
làjati	old_church_slavic	lajati	lajati
làskati	old_church_slavic	laskaaše	laskaaʃɛ
jьzlàziti	old_church_slavic	izlaziti	izlaziti
legti	old_church_slavic	lešti	lɛʃti
letěti	old_church_slavic	letěti	lɛtæti
ležàti	old_church_slavic	ležati	lɛʒati
lěgati	old_church_slavic	lěgati	lægati
lěnìvъ	old_church_slavic	lěnivъ	lænivʊ
lěnъ	old_church_slavic	lěnъ	lænʊ
lěpiti	old_church_slavic	prilěpiti	prilæpiti
lětь	old_church_slavic	lětь	lætɪ
lě̀to	old_church_slavic	lěto	lætɔ
jьzlě̀zti	old_church_slavic	izlěsti	izlæsti
lě̑pъ	old_church_slavic	lěpъ	læpʊ
lě̑sъ	old_church_slavic	lěsъ	læsʊ
lě̑vъ	old_church_slavic	lěvъ	lævʊ
lě̑xà	old_church_slavic	lěxa	læxa
lȇdъ	old_church_slavic	ledъ	lɛdʊ
likъ	old_church_slavic	likъ	likʊ
lisъ	old_church_slavic	lisъ	lisʊ
lixo	old_church_slavic	lixo	lixɔ
lixъ	old_church_slavic	lixъ	lixʊ
lišiti	old_church_slavic	lišiti	liʃiti
lìti	old_church_slavic	-liti	-liti
lobъzati	old_church_slavic	lobъzati	lɔbʊzati
loky	old_church_slavic	lokъvi	lɔkʊvi
lomìti	old_church_slavic	lomiti	lɔmiti
lonò	old_church_slavic	lono	lɔnɔ
lopàta	old_church_slavic	lopata	lɔpata
lovìti	old_church_slavic	loviti	lɔviti
lozà	old_church_slavic	loza	lɔza
lože	old_church_slavic	lože	lɔʒɛ
lȏvъ	old_church_slavic	lovъ	lɔvʊ
lǫkàvъ	old_church_slavic	lǫkavъ	lɔ̃kavʊ
lǭčìti	old_church_slavic	lǫčiti	lɔ̃t͡ʃiti
lǫ̑gъ	old_church_slavic	lǫga	lɔ̃ga
lǫ̑kъ	old_church_slavic	lǫkъ	lɔ̃kʊ
lunà	old_church_slavic	luna	luna
lučiti sę	old_church_slavic	lučiti sę	lut͡ʃiti sɛ̃
līcè	old_church_slavic	lice	lit͡sɛ
līzàti	old_church_slavic	lizaaše	lizaaʃɛ
lǭkà	old_church_slavic	lǫka	lɔ̃ka
lūčà	old_church_slavic	luča	lut͡ʃa
l̨ubo	old_church_slavic	ljubo	ʎubɔ
l̨uby	old_church_slavic	ljuby	ʎubɨ
l̨ubъ	old_church_slavic	ljubъ	ʎubʊ
l̨utъ	old_church_slavic	ljutъ	ʎutʊ
l̨ȗdьje	old_church_slavic	ljudьje	ʎudɪjɛ
l̨ūbìti	old_church_slavic	ljubiti	ʎubiti
lъgati	old_church_slavic	lъgati	lʊgati
lъža	old_church_slavic	lъža	lʊʒa
lъžь	old_church_slavic	lъžь	lʊʒɪ
lьdza	old_church_slavic	l. jestъ	l. jɛstʊ
lьga	old_church_slavic	l.jestъ	l.jɛstʊ
lьgъkъ	old_church_slavic	lьgъkъ	lɪgʊkʊ
lьjati	old_church_slavic	lijati	lijati
lьnǫti	old_church_slavic	prilьnǫti	prilɪnɔ̃ti
lь̑stь	old_church_slavic	lьstь	lɪstɪ
materьstvo	old_church_slavic	materьstva	matɛrɪstva
màlъ	old_church_slavic	malъ	malʊ
màslo	old_church_slavic	maslo	maslɔ
màti	old_church_slavic	mati	mati
màzati	old_church_slavic	mazati	mazati
mȃstь	old_church_slavic	mastь	mastɪ
medjà	old_church_slavic	meždaxъ	mɛʒdaxʊ
medju	old_church_slavic	meždu	mɛʒdu
medvě̀dь	old_church_slavic	medvědь	mɛdvædɪ
melkò	old_church_slavic	mlěko	mlækɔ
melti	old_church_slavic	mlěti	mlæti
mene	old_church_slavic	mene	mɛnɛ
merti	old_church_slavic	mrěti	mræti
metàti	old_church_slavic	metati	mɛtati
mèrža	old_church_slavic	mrěža	mræʒa
měna	old_church_slavic	měna	mæna
měniti	old_church_slavic	měniti	mæniti
mě̀dь	old_church_slavic	mědь	mædɪ
mě̀ra	old_church_slavic	měra	mæra
mě̀riti	old_church_slavic	měriti	mæriti
mě̀sęcь	old_church_slavic	měsęcь	mæsɛ̃t͡sɪ
mě̀sto	old_church_slavic	město	mæstɔ
mě̑sìti	old_church_slavic	měsimъ	mæsimʊ
mȇdъ	old_church_slavic	medъ	mɛdʊ
mę	old_church_slavic	mę	mɛ̃
mękъkъ	old_church_slavic	mękъkъ	mɛ̃kʊkʊ
męsti	old_church_slavic	męsti	mɛ̃sti
mę̑so	old_church_slavic	męso	mɛ̃sɔ
mimo	old_church_slavic	mimo	mimɔ
minovati	old_church_slavic	minovati	minɔvati
minǫti	old_church_slavic	minǫti	minɔ̃ti
mirъ	old_church_slavic	mirъ	mirʊ
mitě	old_church_slavic	mitě	mitæ
mìlъ	old_church_slavic	milъ	milʊ
modliti	old_church_slavic	moliti	mɔliti
mogti	old_church_slavic	mošti	mɔʃti
mogtь	old_church_slavic	moštь	mɔʃtɪ
mojь	old_church_slavic	moi	mɔi
mokrъjь	old_church_slavic	mokrъi	mɔkrʊi
moldenьcь	old_church_slavic	mladenьcь	mladɛnɪt͡sɪ
moldъ	old_church_slavic	mladъ	mladʊ
moldьnъ	old_church_slavic	mladьnъ	mladɪnʊ
monisto	old_church_slavic	monisto	mɔnistɔ
morъ	old_church_slavic	morъ	mɔrʊ
motyka	old_church_slavic	motyky	mɔtɨkɨ
močìti	old_church_slavic	močiti	mɔt͡ʃiti
mošьna	old_church_slavic	mošьna	mɔʃɪna
moždžanъ	old_church_slavic	moždanъ	mɔʒdanʊ
mòrzъ	old_church_slavic	mrazъ	mrazʊ
mȍr̨e	old_church_slavic	morje	mɔrʲɛ
mȏltъ	old_church_slavic	mlatъ	mlatʊ
mȏrkъ	old_church_slavic	mrakъ	mrakʊ
mȏstъ	old_church_slavic	mostъ	mɔstʊ
mǫ̀ka	old_church_slavic	mǫka	mɔ̃ka
mǫ̀čiti	old_church_slavic	mǫčiti	mɔ̃t͡ʃiti
mǫ́drъ	old_church_slavic	mǫdrъ	mɔ̃drʊ
mǭtìti	old_church_slavic	mǫtiti	mɔ̃titi
mǫ̑žь	old_church_slavic	mǫžь	mɔ̃ʒɪ
muditi	old_church_slavic	muditi	muditi
mùxa	old_church_slavic	muxa	muxa
my	old_church_slavic	my	mɨ
myto	old_church_slavic	myto	mɨtɔ
myšьca	old_church_slavic	myšьca	mɨʃɪt͡sa
mỳti	old_church_slavic	myti	mɨti
mỳšь	old_church_slavic	myšъ	mɨʃʊ
my̑slь	old_church_slavic	myslь	mɨslɪ
mǭkà	old_church_slavic	mǫka	mɔ̃ka
mъldni	old_church_slavic	ml̩ni	ml̩ni
mъlva	old_church_slavic	ml̩va	ml̩va
mъlviti	old_church_slavic	ml̩viti	ml̩viti
mъnogъ	old_church_slavic	mъnogъ	mʊnɔgʊ
mъčati	old_church_slavic	mьčimi	mɪt͡ʃimi
mьlčàti	old_church_slavic	ml̩čati	ml̩t͡ʃati
mьně	old_church_slavic	mьně	mɪnæ
mьněti	old_church_slavic	mьněti	mɪnæti
mьn̨e	old_church_slavic	mьnje	mɪɲɛ
mьn̨eje	old_church_slavic	mьnje	mɪɲɛ
mьnьjьjь	old_church_slavic	mьn̨ii	mɪn̨ii
mьrknǫti	old_church_slavic	mr̩knǫti	mr̩knɔ̃ti
mьrzěti	old_church_slavic	mr̩zěti	mr̩zæti
pomьrznǫti	old_church_slavic	pomrъznǫti	pɔmrʊznɔ̃ti
mьstiti	old_church_slavic	mьstiti	mɪstiti
mьzdà	old_church_slavic	mьzda	mɪzda
mьčьtъ	old_church_slavic	mьčьtъ	mɪt͡ʃɪtʊ
mь̀rtvъ	old_church_slavic	mr̩tvъ	mr̩tvʊ
na	old_church_slavic	na	na
nadъ	old_church_slavic	nadъ	nadʊ
nasъ	old_church_slavic	nasъ	nasʊ
naustiti	old_church_slavic	naustiti	naustiti
načęti	old_church_slavic	načęti	nat͡ʃɛ̃ti
náglъ	old_church_slavic	naglo	naglɔ
nȃgъ	old_church_slavic	nagъ	nagʊ
ne	old_church_slavic	ne	nɛ
nebogъ	old_church_slavic	nebogъ	nɛbɔgʊ
nedǫ̀gъ	old_church_slavic	nedǫgъ	nɛdɔ̃gʊ
negodovati	old_church_slavic	negodovati	nɛgɔdɔvati
nejęsytь	old_church_slavic	nejęsyti	nɛjɛ̃sɨti
nestì	old_church_slavic	nesti	nɛsti
nevě̀sta	old_church_slavic	nevěsta	nɛvæsta
nevodъ	old_church_slavic	nevodъ	nɛvɔdʊ
neže	old_church_slavic	neže	nɛʒɛ
nȅbo	old_church_slavic	nebo	nɛbɔ
ni	old_church_slavic	ni	ni
nicь	old_church_slavic	nicь	nit͡sɪ
niže	old_church_slavic	ni že	ni ʒɛ
nìščь	old_church_slavic	ništь	niʃtɪ
nogà	old_church_slavic	noga	nɔga
nogъtь	old_church_slavic	nogъtь	nɔgʊtɪ
nosìti	old_church_slavic	nositi	nɔsiti
nòžь	old_church_slavic	nožь	nɔʒɪ
nȏktь	old_church_slavic	noštь	nɔʃtɪ
nāròdъ	old_church_slavic	narodъ	narɔdʊ
nъ	old_church_slavic	nъ	nʊ
ob	old_church_slavic	o	ɔ
oba	old_church_slavic	oba	ɔba
obětjati	old_church_slavic	oběštati	ɔbæʃtati
obolkъ	old_church_slavic	oblakъ	ɔblakʊ
obrěsti	old_church_slavic	obrěsti	ɔbræsti
obuti	old_church_slavic	obuti	ɔbuti
obьtjь	old_church_slavic	obьštь	ɔbɪʃtɪ
odolě̀ti	old_church_slavic	odolěti	ɔdɔlæti
ojьminъ	old_church_slavic	oimi	ɔimi
oldi	old_church_slavic	aldii	aldii
olnìta	old_church_slavic	lanita	lanita
onutja	old_church_slavic	onušta	ɔnuʃta
onъ	old_church_slavic	onъ	ɔnʊ
oràti	old_church_slavic	orati	ɔrati
orbòta	old_church_slavic	rabota	rabɔta
orbъ	old_church_slavic	rabъ	rabʊ
oriti	old_church_slavic	oriši	ɔriʃi
orǫdьje	old_church_slavic	orǫdije	ɔrɔ̃dijɛ
orsti	old_church_slavic	rasti	rasti
ortь	old_church_slavic	ratь	ratɪ
orz	old_church_slavic	raz-	raz-
orь̀lъ	old_church_slavic	orьlъ	ɔrɪlʊ
oskъrdъ	old_church_slavic	oskr̩dъ	ɔskr̩dʊ
osmъ	old_church_slavic	osmъ	ɔsmʊ
ostrovъ	old_church_slavic	ostrovъ	ɔstrɔvʊ
ostrъ	old_church_slavic	ostrъ	ɔstrʊ
ostь̀nъ	old_church_slavic	ostьnъ	ɔstɪnʊ
osъ̀tъ	old_church_slavic	osъtъ	ɔsʊtʊ
osьla	old_church_slavic	osla	ɔsla
osь̀lъ	old_church_slavic	osьlъ	ɔsɪlʊ
ot	old_church_slavic	otъ	ɔtʊ
otjutiti	old_church_slavic	oštutiti	ɔʃtutiti
otlěkъ	old_church_slavic	otъlěkъ	ɔtʊlækʊ
otrokъ	old_church_slavic	otrokъ	ɔtrɔkʊ
otverzti	old_church_slavic	otvrěsti	ɔtvræsti
otvětjati	old_church_slavic	otъvěštati	ɔtʊvæʃtati
otvorìti	old_church_slavic	otvoriti	ɔtvɔriti
otъ	old_church_slavic	otъ	ɔtʊ
otъlěkъ	old_church_slavic	otъlěkъ	ɔtʊlækʊ
otъverzti	old_church_slavic	otvrěsti	ɔtvræsti
otъvětjati	old_church_slavic	otъvěštati	ɔtʊvæʃtati
otъvorìti	old_church_slavic	otvoriti	ɔtvɔriti
otьcь	old_church_slavic	otьcь	ɔtɪt͡sɪ
ovъ	old_church_slavic	ovъ	ɔvʊ
ovьcà	old_church_slavic	ovьca	ɔvɪt͡sa
ovьnъ	old_church_slavic	ovьnъ	ɔvɪnʊ
òdrъ	old_church_slavic	odrъ	ɔdrʊ
ògn'ь	old_church_slavic	ognь	ɔgnɪ
òlkati	old_church_slavic	alъkati	alʊkati
olkomъjь	old_church_slavic	lakomyi	lakɔmɨi
olkomъjьjь	old_church_slavic	lakomyi	lakɔmɨi
òlni	old_church_slavic	alъnii	alʊnii
òlčьnъ	old_church_slavic	alʹčenъ	aʎt͡ʃɛnʊ
òrdlo	old_church_slavic	ralo	ralɔ
òsmь	old_church_slavic	osmь	ɔsmɪ
ȍko	old_church_slavic	oko	ɔkɔ
ȍlovo	old_church_slavic	ólovo	ólɔvɔ
ǫtrь	old_church_slavic	ǫtrь	ɔ̃trɪ
ǫzъkъ	old_church_slavic	ǫzъkъ	ɔ̃zʊkʊ
ǫ̀glь	old_church_slavic	ǫglь	ɔ̃glɪ
ǫ̑gъlъ	old_church_slavic	ǫgъlъ	ɔ̃gʊlʊ
palica	old_church_slavic	palica	palit͡sa
pariti	old_church_slavic	paręštę	parɛ̃ʃtɛ̃
pasti	old_church_slavic	pasti	pasti
pasti sę	old_church_slavic	pasti sę	pasti sɛ̃
paxati	old_church_slavic	paxati	paxati
pazduxa	old_church_slavic	pazuxa	pazuxa
pažitь	old_church_slavic	pažitь	paʒitɪ
pàdati	old_church_slavic	padati	padati
pàmętь	old_church_slavic	pamętь	pamɛ̃tɪ
pekti	old_church_slavic	pešti	pɛʃti
per	old_church_slavic	prě-	præ-
perdъ	old_church_slavic	prědъ	prædʊ
pèlti	old_church_slavic	plěvoma	plævɔma
pèlva	old_church_slavic	plěvy	plævɨ
pěsъ̀kъ	old_church_slavic	pěsъkъ	pæsʊkʊ
pěti	old_church_slavic	pěti	pæti
pěšь	old_church_slavic	pěšь	pæʃɪ
pě̀na	old_church_slavic	pěny	pænɨ
pȇktь	old_church_slavic	peštь	pɛʃtɪ
pȇlnъ	old_church_slavic	plěnъ	plænʊ
pę̑tь	old_church_slavic	pętь	pɛ̃tɪ
pętà	old_church_slavic	pęta	pɛ̃ta
pętъ	old_church_slavic	pętъ	pɛ̃tʊ
pę̑dь	old_church_slavic	pędь	pɛ̃dɪ
pitati	old_church_slavic	pitati	pitati
pitěti	old_church_slavic	pitěti	pitæti
pìti	old_church_slavic	piti	piti
pìtja	old_church_slavic	pišta	piʃta
pȋvo	old_church_slavic	pivo	pivɔ
pjьvàti	old_church_slavic	pl̨ьvati	pl̨ɪvati
plàkati sę	old_church_slavic	plakati sę	plakati sɛ̃
plàvati	old_church_slavic	plavati	plavati
plesti	old_church_slavic	pletomi	plɛtɔmi
pletjè	old_church_slavic	plešte	plɛʃtɛ
ploskъ	old_church_slavic	ploskъ	plɔskʊ
plotъ	old_church_slavic	plotъ	plɔtʊ
pluti	old_church_slavic	plu	plu
pl̨ūtjè	old_church_slavic	pljušta	pʎuʃta
podorgъ	old_church_slavic	podragъ	pɔdragʊ
podòba	old_church_slavic	podoba	pɔdɔba
podъ	old_church_slavic	podъ	pɔdʊ
poìti	old_church_slavic	poilъ	pɔilʊ
pokòjь	old_church_slavic	pokoi	pɔkɔi
polěti	old_church_slavic	polěti	pɔlæti
poltьnò	old_church_slavic	platьno	platɪnɔ
polvъ	old_church_slavic	plavъ	plavʊ
polъ	old_church_slavic	polъ	pɔlʊ
polьdza	old_church_slavic	polьdza	pɔlɪdza
posětiti	old_church_slavic	posětiti	pɔsætiti
povinǫti	old_church_slavic	povinǫti	pɔvinɔ̃ti
pozdъ	old_church_slavic	pozdě	pɔzdæ
pozdьnъ	old_church_slavic	pozdьnъ	pɔzdɪnʊ
počìti	old_church_slavic	počiti	pɔt͡ʃiti
pòlmy	old_church_slavic	plamy	plamɨ
pòrgъ	old_church_slavic	pragъ	pragʊ
pȍjāsъ	old_church_slavic	pojasъ	pɔjasʊ
pȍl̨e	old_church_slavic	polje	pɔʎɛ
pȏrxъ	old_church_slavic	praxъ	praxʊ
pȏtъ	old_church_slavic	potъ	pɔtʊ
pǫčina	old_church_slavic	pǫčina	pɔ̃t͡ʃina
pǫ̀to	old_church_slavic	pǫta	pɔ̃ta
pǫ́tь	old_church_slavic	pǫtь	pɔ̃tɪ
pràvъ	old_church_slavic	pravъ	pravʊ
vъzprę̀dnǫti	old_church_slavic	vъspręnǫti	vʊsprɛ̃nɔ̃ti
pręsti	old_church_slavic	prędǫtъ	prɛ̃dɔ̃tʊ
pri	old_church_slavic	pri	pri
prijatelь	old_church_slavic	prijatel̨ь	prijatɛl̨ɪ
prijati	old_church_slavic	prijati	prijati
prokъjь	old_church_slavic	prokyi	prɔkɨi
prosějati	old_church_slavic	prosěati	prɔsæati
prosìti	old_church_slavic	prositi	prɔsiti
prosterti	old_church_slavic	prostrěti	prɔstræti
proverti	old_church_slavic	provrěšę	prɔvræʃɛ̃
pròčь	old_church_slavic	pročь	prɔt͡ʃɪ
prȏstъ	old_church_slavic	prostъ	prɔstʊ
prǫgъ	old_church_slavic	prǫgъ	prɔ̃gʊ
pustìti	old_church_slavic	pustiti	pustiti
pȗstъ	old_church_slavic	pustъ	pustʊ
pȳtàti	old_church_slavic	pytati	pɨtati
pālìti	old_church_slavic	paliti	paliti
pъlkъ	old_church_slavic	pl̩kъ	pl̩kʊ
pъtìca	old_church_slavic	pъtica	pʊtit͡sa
pьrati	old_church_slavic	perǫtъ	pɛrɔ̃tʊ
pьrěti	old_church_slavic	pьrěti	pɪræti
jьzpьrgnǫti	old_church_slavic	ispr̩gnǫti	ispr̩gnɔ̃ti
pьrvъ	old_church_slavic	pr̩vъ	pr̩vʊ
pьsàti	old_church_slavic	pьsati	pɪsati
pь̀lnъ	old_church_slavic	pl̩nъ	pl̩nʊ
pь̀lzati	old_church_slavic	pl̩zati	pl̩zati
pь̀rstъ	old_church_slavic	pr̩stъ	pr̩stʊ
pь̀rsь	old_church_slavic	pr̩si	pr̩si
pь̀sъ	old_church_slavic	pьsъ	pɪsʊ
pь̑rstь	old_church_slavic	pr̩stь	pr̩stɪ
radi	old_church_slavic	radi	radi
raditi	old_church_slavic	raditi	raditi
razoriti	old_church_slavic	razoriti	razɔriti
rebrò	old_church_slavic	rebro	rɛbrɔ
rekti	old_church_slavic	rešti	rɛʃti
remy	old_church_slavic	remenь	rɛmɛnɪ
rědъkъ	old_church_slavic	rědъkyję	rædʊkɨjɛ̃
rějati	old_church_slavic	rějati	ræjati
rě̄kà	old_church_slavic	rěka	ræka
rě̑čь	old_church_slavic	rěčь	ræt͡ʃɪ
rę̑dъ	old_church_slavic	rędъ	rɛ̃dʊ
rìnǫti sę	old_church_slavic	rinǫšę sę	rinɔ̃ʃɛ̃ sɛ̃
rodìti	old_church_slavic	roditi	rɔditi
rokъ	old_church_slavic	rokъ	rɔkʊ
rosà	old_church_slavic	rosa	rɔsa
rovъ	old_church_slavic	rovъ	rɔvʊ
rȏdъ	old_church_slavic	rodъ	rɔdʊ
rȏgъ	old_church_slavic	rogъ	rɔgʊ
rǭkà	old_church_slavic	rǫka	rɔ̃ka
rỳdlo	old_church_slavic	rýlo	rýlɔ
rỳti	old_church_slavic	ryti	rɨti
rāčìti	old_church_slavic	račiti	rat͡ʃiti
rūnò	old_church_slavic	runo	runɔ
r̨uti	old_church_slavic	revy	rɛvɨ
sadìti	old_church_slavic	saditi	saditi
sȃdъ	old_church_slavic	sadъ	sadʊ
seló	old_church_slavic	selo	sɛlɔ
serdà	old_church_slavic	srěda	sræda
sestrà	old_church_slavic	sestra	sɛstra
sèdmъ	old_church_slavic	sedmъ	sɛdmʊ
sèdmь	old_church_slavic	sedmь	sɛdmɪ
sěděti	old_church_slavic	sěděti	sædæti
sěkti	old_church_slavic	sěšti	sæʃti
sěsti	old_church_slavic	sěsti	sæsti
sětь	old_church_slavic	sětь	sætɪ
sě̀jati	old_church_slavic	sěti	sæti
sě̀mę	old_church_slavic	sěmę	sæmɛ̃
sě̀nь	old_church_slavic	sěnь	sænɪ
sě̀ti	old_church_slavic	sěti	sæti
sě̀verъ	old_church_slavic	sěverъ	sævɛrʊ
sě̑no	old_church_slavic	sěno	sænɔ
sęgti sę	old_church_slavic	prisęšti sę	prisɛ̃ʃti sɛ̃
jьzsęknǫti	old_church_slavic	isęknǫti	isɛ̃knɔ̃ti
sijàti	old_church_slavic	sijati	sijati
sìla	old_church_slavic	sila	sila
slàbъ	old_church_slavic	slabъ	slabʊ
slàva	old_church_slavic	slava	slava
slìna	old_church_slavic	sliny	slinɨ
slȍvo	old_church_slavic	slovo	slɔvɔ
sluti	old_church_slavic	sluti	sluti
slùšati	old_church_slavic	slušati	sluʃati
slȗxъ	old_church_slavic	sluxъ	sluxʊ
slỳšati	old_church_slavic	slyšati	slɨʃati
směxъ	old_church_slavic	směxъ	smæxʊ
smȏrdъ	old_church_slavic	smradъ	smradʊ
smьjàti sę	old_church_slavic	smijati sę	smijati sɛ̃
smьrdě̀ti	old_church_slavic	smr̩děti	smr̩dæti
sněgъ	old_church_slavic	sněgъ	snægʊ
solnà	old_church_slavic	slana	slana
solnъ	old_church_slavic	slanъ	slanʊ
soltina	old_church_slavic	slatina	slatina
sovati	old_church_slavic	sovaatъ	sɔvaatʊ
sòldъkъ	old_church_slavic	sladъkъ	sladʊkʊ
sȏkъ	old_church_slavic	sokomъ	sɔkɔmʊ
sȏlь	old_church_slavic	solь	sɔlɪ
sǫ-	old_church_slavic	sǫ-	sɔ̃-
sǫditi	old_church_slavic	sǫditi	sɔ̃diti
sǫdì	old_church_slavic	sǫdi	sɔ̃di
sǫ́dъ	old_church_slavic	sǫdъ	sɔ̃dʊ
sǫ̑kъ	old_church_slavic	sǫkъ	sɔ̃kʊ
spěšiti	old_church_slavic	spěšiti	spæʃiti
spě̀ti	old_church_slavic	spěti	spæti
spě̑xъ	old_church_slavic	spěxъ	spæxʊ
stàdo	old_church_slavic	stado	stadɔ
stàrъ	old_church_slavic	starъ	starʊ
stàti	old_church_slavic	stati	stati
stàviti	old_church_slavic	staviti	staviti
stȃnъ	old_church_slavic	stanъ	stanʊ
stenàti	old_church_slavic	stenati	stɛnati
stergti	old_church_slavic	strěšti	stræʃti
stě̀nь	old_church_slavic	stěnь	stænɪ
postìgnǫti	old_church_slavic	postignǫti	pɔstignɔ̃ti
stogъ	old_church_slavic	stogъ	stɔgʊ
stojati	old_church_slavic	stojati	stɔjati
stornà	old_church_slavic	strana	strana
stòlъ	old_church_slavic	stol	stɔl
stȏržь	old_church_slavic	stražь	straʒɪ
strigti	old_church_slavic	strišti	striʃti
strujà	old_church_slavic	struja	struja
strȗpъ	old_church_slavic	strupъ	strupʊ
studènъ	old_church_slavic	studenъ	studɛnʊ
studъ	old_church_slavic	studъ	studʊ
stьdzà	old_church_slavic	stьdza	stɪdza
stьgna	old_church_slavic	stьgna	stɪgna
stьlati	old_church_slavic	stьlati	stɪlati
sujь	old_church_slavic	suěa	suæa
sušìti	old_church_slavic	sušiti	suʃiti
sȗxъ	old_church_slavic	suxъ	suxʊ
svekry	old_church_slavic	svekry	svɛkrɨ
svě̄tjà	old_church_slavic	svěšta	svæʃta
svě̑tъ	old_church_slavic	světъ	svætʊ
svędnǫti	old_church_slavic	prisvęnǫti	prisvɛ̃nɔ̃ti
svętъ	old_church_slavic	svętъ	svɛ̃tʊ
svinъ	old_church_slavic	svinъ	svinʊ
svinьjà	old_church_slavic	svinija	svinija
svьtěti sę	old_church_slavic	svьtěti sę	svɪtæti sɛ̃
sỳrъ	old_church_slavic	syrъ	sɨrʊ
sỳtъ	old_church_slavic	syta	sɨta
sỳtъjь	old_church_slavic	syta	sɨta
sy̑nъ	old_church_slavic	synъ	sɨnʊ
sīdlò	old_church_slavic	silo	silɔ
sъ	old_church_slavic	sъ	sʊ
sъdòrvъ	old_church_slavic	sъdravъ	sʊdravʊ
sъlàti	old_church_slavic	sъlati	sʊlati
sъlъ	old_church_slavic	sъlъ	sʊlʊ
sъmè̌ti	old_church_slavic	sъměti	sʊmæti
sъmьrtь	old_church_slavic	sъmr̩tь	sʊmr̩tɪ
sъn	old_church_slavic	sъ	sʊ
sъpati	old_church_slavic	sъpati	sʊpati
sъrěsti	old_church_slavic	sъrěsti	sʊræsti
sъsàti	old_church_slavic	sъsati	sʊsati
sъtȏ	old_church_slavic	sъto	sʊtɔ
sъxnǫti	old_church_slavic	sьxněaše	sɪxnæaʃɛ
sъ̀nъ	old_church_slavic	sъnъ	sʊnʊ
sъ̏lnьce	old_church_slavic	sl̩nьce	sl̩nɪt͡sɛ
sь	old_church_slavic	sь	sɪ
sь̑rdьce	old_church_slavic	sr̩dьce	sr̩dɪt͡sɛ
tajìti	old_church_slavic	taiti	taiti
tatь	old_church_slavic	tatь	tatɪ
tàjati	old_church_slavic	tajati	tajati
tekti	old_church_slavic	tešti	tɛʃti
telktì	old_church_slavic	tlěšti	tlæʃti
teplъ	old_church_slavic	toplъ	tɔplʊ
tesàti	old_church_slavic	tesati	tɛsati
teti	old_church_slavic	teti	tɛti
těsnъ	old_church_slavic	těsnъ	tæsnʊ
tęžъkъ	old_church_slavic	tęžъkъ	tɛ̃ʒʊkʊ
utoliti	old_church_slavic	utoliti	utɔliti
potopìti	old_church_slavic	potopiti	pɔtɔpiti
tȏkъ	old_church_slavic	tokъ	tɔkʊ
tretьjь	old_church_slavic	tretii	trɛtii
trě̄và	old_church_slavic	trěva	træva
tręsti	old_church_slavic	tręsti	trɛ̃sti
trǫdъ	old_church_slavic	trǫdъ	trɔ̃dʊ
trudъ	old_church_slavic	trudъ	trudʊ
truti	old_church_slavic	natruti	natruti
trȗpъ	old_church_slavic	trupъ	trupʊ
trāvà	old_church_slavic	trava	trava
trāvìti	old_church_slavic	travęštiima	travɛ̃ʃtiima
trъ̑stь	old_church_slavic	trьstь	trɪstɪ
tučьnъ	old_church_slavic	tučьnъ	tut͡ʃɪnʊ
tȗkъ	old_church_slavic	tukъ	tukʊ
tȗrъ	old_church_slavic	turomъ	turɔmʊ
tvȃrь	old_church_slavic	tvarь	tvarɪ
tvorìti	old_church_slavic	tvoriti	tvɔriti
tvorъ	old_church_slavic	tvorъ	tvɔrʊ
tvьrdь	old_church_slavic	tvr̩dь	tvr̩dɪ
tvь̑rdъ	old_church_slavic	tvr̩dъ	tvr̩dʊ
ty	old_church_slavic	ty	tɨ
tǭgà	old_church_slavic	tǫga	tɔ̃ga
tъ	old_church_slavic	tъ	tʊ
tъ̀ščь	old_church_slavic	tъštъ	tʊʃtʊ
tъ̀ščьjь	old_church_slavic	tъštъ	tʊʃtʊ
tьlěti	old_church_slavic	tьlěti	tɪlæti
tьma	old_church_slavic	tьma	tɪma
tь̏nьkъ	old_church_slavic	tъnъčaje	tʊnʊt͡ʃajɛ
užasъ	old_church_slavic	užasъ	uʒasʊ
vaditi	old_church_slavic	vaditi	vaditi
varìti	old_church_slavic	variti	variti
vasъ	old_church_slavic	vasъ	vasʊ
vȃrъ	old_church_slavic	varъ	varʊ
vedro	old_church_slavic	vedro	vɛdrɔ
velě̀ti	old_church_slavic	velěti	vɛlæti
velìkъ	old_church_slavic	velikъ	vɛlikʊ
velkti	old_church_slavic	vlěšti	vlæʃti
velьmi	old_church_slavic	velьmi	vɛlɪmi
vergti	old_church_slavic	vrěšti	vræʃti
vermę	old_church_slavic	vrěmę	vræmɛ̃
veslò	old_church_slavic	vesla	vɛsla
vesnà	old_church_slavic	vesnǫ	vɛsnɔ̃
vesti	old_church_slavic	vesti	vɛsti
vetъxъ	old_church_slavic	vetъxъ	vɛtʊxʊ
veztì	old_church_slavic	vesti	vɛsti
věděti	old_church_slavic	věděti	vædæti
vědrò	old_church_slavic	vědro	vædrɔ
věja	old_church_slavic	věja	væja
větjati	old_church_slavic	věštati	væʃtati
vě̀jati	old_church_slavic	vějati	væjati
vě̀ko	old_church_slavic	věkoma	vækɔma
vě̀ra	old_church_slavic	věra	væra
vě̀trъ	old_church_slavic	větrъ	vætrʊ
vȅčerъ	old_church_slavic	večerъ	vɛt͡ʃɛrʊ
vę̄zàti	old_church_slavic	vęzati	vɛ̃zati
viti	old_church_slavic	viti	viti
vìděti	old_church_slavic	viděti	vidæti
vȋdъ	old_church_slavic	vidъ	vidʊ
vodà	old_church_slavic	voda	vɔda
vodìti	old_church_slavic	voditi	vɔditi
voliti	old_church_slavic	voliti	vɔliti
volsti	old_church_slavic	vlasti	vlasti
volstь	old_church_slavic	vlastь	vlastɪ
vorta	old_church_slavic	vrata	vrata
vortìti sę	old_church_slavic	vratiti sę	vratiti sɛ̃
voskъ	old_church_slavic	voskъ	vɔskʊ
vòlga	old_church_slavic	vlaga	vlaga
vòl̨a	old_church_slavic	volja	vɔʎa
vȏlsъ	old_church_slavic	vlasъ	vlasʊ
vȏrgъ	old_church_slavic	vragъ	vragʊ
vȏrnъ	old_church_slavic	vranъ	vranʊ
vȏzъ	old_church_slavic	vozy	vɔzɨ
vy	old_church_slavic	vy	vɨ
vy-	old_church_slavic	vy-	vɨ-
vysòkъ	old_church_slavic	vysokъ	vɨsɔkʊ
vỳknǫti	old_church_slavic	vyknǫti	vɨknɔ̃ti
vъ	old_church_slavic	vъ	vʊ
vъn	old_church_slavic	vъ	vʊ
vъnoziti	old_church_slavic		
vъnъ	old_church_slavic	vъnъ	vʊnʊ
vъnьznǫti	old_church_slavic	vъnъznǫti	vʊnʊznɔ̃ti
vъnьzti	old_church_slavic	vъnьzi	vʊnɪzi
vъpìti	old_church_slavic	vъpiti	vʊpiti
vъsuje	old_church_slavic	vъsuje	vʊsujɛ
vъtorъjь	old_church_slavic	vъtorъ	vʊtɔrʊ
vьdovà	old_church_slavic	vъdova	vʊdɔva
vьlnà	old_church_slavic	vl̩na	vl̩na
vьrěti	old_church_slavic	vьręštę	vɪrɛ̃ʃtɛ̃
vьrtě̀ti sę	old_church_slavic	vr̩titъ sę	vr̩titʊ sɛ̃
vьśь	old_church_slavic	vьsь	vɪsɪ
vьsь	old_church_slavic	vьsь	vɪsɪ
vьčera	old_church_slavic	vьčera	vɪt͡ʃɛra
vь̀lna	old_church_slavic	vl̩na	vl̩na
vь̀rxъ	old_church_slavic	vr̩xъ	vr̩xʊ
vь̑lkъ	old_church_slavic	vl̩kъ	vl̩kʊ
xlě̀bъ	old_church_slavic	xlěbъ	xlæbʊ
xlębь	old_church_slavic	xljębei	xʎɛ̃bɛi
xoditi	old_church_slavic	xoditi	xɔditi
xoldьnъ	old_church_slavic	xladьnъ	xladɪnʊ
xorbrъ	old_church_slavic	xrabъrъ	xrabʊrʊ
xorniti	old_church_slavic	xraniti	xraniti
xȏdъ	old_church_slavic	xodъ	xɔdʊ
xȏldъ	old_church_slavic	xladъ	xladʊ
xromъ	old_church_slavic	xromъ	xrɔmʊ
xȗdъ	old_church_slavic	xudъ	xudʊ
zar̨à	old_church_slavic	zarja	zarʲa
zaverti	old_church_slavic	zavьri	zavɪri
zelènъ	old_church_slavic	zelenъ	zɛlɛnʊ
zelьje	old_church_slavic	zelije	zɛlijɛ
zeml̨à	old_church_slavic	zemlja	zɛmʎa
zěnica	old_church_slavic	zěnica	zænit͡sa
prozębnǫti	old_church_slavic	prozębnǫti	prɔzɛ̃bnɔ̃ti
zęti	old_church_slavic	zębomi	zɛ̃bɔmi
zę̀tь	old_church_slavic	zętь	zɛ̃tɪ
zìnǫti	old_church_slavic	zinǫti	zinɔ̃ti
zmьjà	old_church_slavic	zmija	zmija
zmь̀jь	old_church_slavic	zmii	zmii
znamenьje	old_church_slavic	znamenie	znamɛniɛ
znàti	old_church_slavic	znati	znati
znojь	old_church_slavic	znoi	znɔi
zobàti	old_church_slavic	ozoba	ɔzɔba
zȍlto	old_church_slavic	zlato	zlatɔ
zȏrkъ	old_church_slavic	zrakъ	zrakʊ
zīmà	old_church_slavic	zima	zima
zъlъ	old_church_slavic	zъlъ	zʊlʊ
zъvati	old_church_slavic	zъvati	zʊvati
zьdati	old_church_slavic	zьdati	zɪdati
zьlčь	old_church_slavic	zl̩čь	zl̩t͡ʃɪ
zьrěti	old_church_slavic	zьrěti	zɪræti
zь̀rno	old_church_slavic	zr̩no	zr̩nɔ
čarodějь	old_church_slavic	čaroděi	t͡ʃarɔdæi
čarъ	old_church_slavic	čary	t͡ʃarɨ
čàjati	old_church_slavic	čajati	t͡ʃajati
čàsъ	old_church_slavic	časъ	t͡ʃasʊ
čelověkъ	old_church_slavic	člověkъ	t͡ʃlɔvækʊ
čelò	old_church_slavic	čelo	t͡ʃɛlɔ
čel̨adь	old_church_slavic	čelědijǫ	t͡ʃɛlædijɔ̃
černovъ	old_church_slavic	črěnovьnyję	t͡ʃrænɔvɪnɨjɛ̃
počerpti	old_church_slavic	počrěti	pɔt͡ʃræti
čerslò	old_church_slavic	črěsla	t͡ʃræsla
česàti	old_church_slavic	česati	t͡ʃɛsati
četvьrtъ	old_church_slavic	četvrьtъ	t͡ʃɛtvrɪtʊ
četỳre	old_church_slavic	četyre	t͡ʃɛtɨrɛ
čȇrvo	old_church_slavic	črěvo	t͡ʃrævɔ
čędь	old_church_slavic	čędь	t͡ʃɛ̃dɪ
čęstъ	old_church_slavic	čęstъ	t͡ʃɛ̃stʊ
čę̑stь	old_church_slavic	čęstь	t͡ʃɛ̃stɪ
činìti	old_church_slavic	činiti	t͡ʃiniti
čisti	old_church_slavic	čisti	t͡ʃisti
čìstiti	old_church_slavic	čistiti	t͡ʃistiti
čìstъ	old_church_slavic	čistъ	t͡ʃistʊ
čȋnъ	old_church_slavic	činъ	t͡ʃinʊ
čuditi sę	old_church_slavic	čuditi sę	t͡ʃuditi sɛ̃
čùdo	old_church_slavic	čudo	t͡ʃudɔ
čùti	old_church_slavic	čuti	t͡ʃuti
čьrmьnovati sę	old_church_slavic	črъmъnuetъ sę	t͡ʃrʊmʊnuɛtʊ sɛ̃
čьrmьnъ	old_church_slavic	čr̩mьnъ	t͡ʃr̩mɪnʊ
čьrpati	old_church_slavic	črěpьjǫšte	t͡ʃræpɪjɔ̃ʃtɛ
čьrtà	old_church_slavic	čr̩ta	t͡ʃr̩ta
čьrvь	old_church_slavic	čr̩vь	t͡ʃr̩vɪ
čьto	old_church_slavic	čьto	t͡ʃɪtɔ
čь̀rnъ	old_church_slavic	čr̩nъ	t͡ʃr̩nʊ
čь̑stь	old_church_slavic	čьstь	t͡ʃɪstɪ
ǭtròba	old_church_slavic	ǫtroba	ɔ̃trɔba
šȇstъ	old_church_slavic	šestъ	ʃɛstʊ
šȇstь	old_church_slavic	šestь	ʃɛstɪ
šibati	old_church_slavic	šibaaxǫ	ʃibaaxɔ̃
šujьjь	old_church_slavic	šui	ʃui
ščítъ	old_church_slavic	štitъ	ʃtitʊ
ūstà	old_church_slavic	usta	usta
ūzdà	old_church_slavic	uzda	uzda
žalь	old_church_slavic	žalь	ʒalɪ
žàba	old_church_slavic	žaba	ʒaba
že	old_church_slavic	že	ʒɛ
žegti	old_church_slavic	žešti	ʒɛʃti
želě̀zo	old_church_slavic	želězo	ʒɛlæzɔ
želsti	old_church_slavic	žlěsti	ʒlæsti
žel̨a	old_church_slavic	žel̨a	ʒɛl̨a
ženà	old_church_slavic	žena	ʒɛna
žerbьjь	old_church_slavic	žrěbii	ʒræbii
požerti	old_church_slavic	požrěti	pɔʒræti
žę̄dàti	old_church_slavic	žędati	ʒɛ̃dati
žęti	old_church_slavic	žęti	ʒɛ̃ti
žę̀dlo	old_church_slavic	žęlo	ʒɛ̃lɔ
žę̀tva	old_church_slavic	žętva	ʒɛ̃tva
žę́dja	old_church_slavic	žažda	ʒaʒda
živòtъ	old_church_slavic	životъ	ʒivɔtʊ
žìla	old_church_slavic	žila	ʒila
žìti	old_church_slavic	žiti	ʒiti
žìto	old_church_slavic	žito	ʒitɔ
žȋvъ	old_church_slavic	živъ	ʒivʊ
žьdàti	old_church_slavic	žьdati	ʒɪdati
žьrny	old_church_slavic	žr̩ny	ʒr̩nɨ
žьrtva	old_church_slavic	žrьtva	ʒrɪtva
žьrьcь	old_church_slavic	žьrьcь	ʒɪrɪt͡sɪ
arьmò	old_church_slavic	jarьmъ	jarɪmʊ
àblъkъ	old_church_slavic	ablъko	ablʊkɔ
bedra	old_church_slavic	bedra	bɛdra
bliskati sę	old_church_slavic	bliskati sę	bliskati sɛ̃
blizь	old_church_slavic	blizъ	blizʊ
bràtrъ	old_church_slavic	bratrъ	bratrʊ
bràtьja	old_church_slavic	bratrija	bratrija
bъ̀drъ	old_church_slavic	bъdrъ	bʊdrʊ
dal̨a	old_church_slavic	dalja	daʎa
děl̨a	old_church_slavic	děl̨a	dæl̨a
dira	old_church_slavic	dira	dira
divь	old_church_slavic	divii	divii
drevje	old_church_slavic	drevlje	drɛvʎɛ
drevьnь	old_church_slavic	drevl̨ьn̨ь	drɛvl̨ɪn̨ɪ
droždža	old_church_slavic	droždьję	drɔʒdɪjɛ̃
drьkolь	old_church_slavic	drьkolь	drɪkɔlɪ
dvogubьnъ	old_church_slavic	dvogubьnъ	dvɔgubɪnʊ
edinakъ	old_church_slavic	jedinako	jɛdinakɔ
edìnъ	old_church_slavic	jedinъ	jɛdinʊ
edъvà	old_church_slavic	jedъva	jɛdʊva
elenь	old_church_slavic	jelenь	jɛlɛnɪ
ȅzerъ	old_church_slavic	jezero	jɛzɛrɔ
ędza	old_church_slavic	jędza	jɛ̃dza
glezna	old_church_slavic	glezně	glɛznæ
glumъ	old_church_slavic	glumъ	glumʊ
gordjь	old_church_slavic	graždъ	graʒdʊ
gorno	old_church_slavic	granъ	granʊ
grozdьno	old_church_slavic	groznъ	grɔznʊ
grǫbъ	old_church_slavic	grǫbъ	grɔ̃bʊ
gvozdь	old_church_slavic	gvozdie	gvɔzdiɛ
jьgrь	old_church_slavic	igrь	igrɪ
klìcati	old_church_slavic	klicati	klit͡sati
klъcati	old_church_slavic	klъcaše	klʊt͡saʃɛ
kogъda	old_church_slavic	kogda	kɔgda
kotora	old_church_slavic	kotora	kɔtɔra
kotorъ	old_church_slavic	kotorъi	kɔtɔrʊi
kysělъ	old_church_slavic	kysělu	kɨsælu
kъrma	old_church_slavic	kr̩ma	kr̩ma
lemešь	old_church_slavic	lemešь	lɛmɛʃɪ
lęcati	old_church_slavic	lęčǫtъ	lɛ̃t͡ʃɔ̃tʊ
lędvьja	old_church_slavic	lędviję	lɛ̃dvijɛ̃
prol̨udinъ	old_church_slavic	prostъ ljudinъ	prɔstʊ ʎudinʊ
mavati	old_church_slavic	namaiaaxǫ	namaiaaxɔ̃
mèčь	old_church_slavic	mečь	mɛt͡ʃɪ
mělъ	old_church_slavic	měla	mæla
mě̑xъ	old_church_slavic	měxъ	mæxʊ
mьglà	old_church_slavic	mьgla	mɪgla
mьstь	old_church_slavic	mьstь	mɪstɪ
někъto	old_church_slavic	někъto	nækʊtɔ
nikati	old_church_slavic	ničetъ	nit͡ʃɛtʊ
norvъ	old_church_slavic	nravъ	nravʊ
nozdr̨a	old_church_slavic	nozdri	nɔzdri
nǫditi	old_church_slavic	nǫditi	nɔ̃diti
nǫ̀dja	old_church_slavic	nǫžda	nɔ̃ʒda
nyně	old_church_slavic	nyně	nɨnæ
òrmo	old_church_slavic	ramo	ramɔ
ȍlkъtь	old_church_slavic	lakъtь	lakʊtɪ
ȍpaky	old_church_slavic	opaky	ɔpakɨ
po	old_church_slavic	po	pɔ
paznegъtь	old_church_slavic	paznegъti	paznɛgʊti
pelna	old_church_slavic	pelena	pɛlɛna
plesno	old_church_slavic	plesno	plɛsnɔ
pro	old_church_slavic	pro-	prɔ-
protivъ	old_church_slavic	protivъ	prɔtivʊ
pīskàti	old_church_slavic	piskati	piskati
pьcьlъ	old_church_slavic	pьcьlъ	pɪt͡sɪlʊ
surovъ	old_church_slavic	surovъ	surɔvʊ
tęgati	old_church_slavic	tęži	tɛ̃ʒi
tr̨ьje	old_church_slavic	trije	trijɛ
tỳsǫti	old_church_slavic	tysǫšti	tɨsɔ̃ʃti
tьlò	old_church_slavic	na tьlěxъ	na tɪlæxʊ
voinъ	old_church_slavic	voi	vɔi
vòn̨a	old_church_slavic	vonja	vɔɲa
vъtorьnikъ	old_church_slavic	vъtorъnikъ	vʊtɔrʊnikʊ
vьrsta	old_church_slavic	vr̩sta	vr̩sta
zidъ	old_church_slavic	zъdě	zʊdæ
zijati	old_church_slavic	zijati	zijati
čerdà	old_church_slavic	črěda	t͡ʃræda
čermъšь	old_church_slavic	črěmošь	t͡ʃræmɔʃɪ
četvorъ	old_church_slavic	četvorъ	t͡ʃɛtvɔrʊ
čędъ	old_church_slavic	čędo	t͡ʃɛ̃dɔ
želàti	old_church_slavic	želěti	ʒɛlæti
žьzlъ	old_church_slavic	žьzlъ	ʒɪzlʊ
žьrti	old_church_slavic	žr̩ti	ʒr̩ti
